Day,Date,Page_Loads,Unique_Visits,First_Time_Visits,Returning_Visits
Sunday,9/14/2014,2146,1582,1430,152
Monday,9/15/2014,3621,2528,2297,231
Tuesday,9/16/2014,3698,2630,2352,278
Wednesday,9/17/2014,3667,2614,2327,287
Thursday,9/18/2014,3316,2366,2130,236
Friday,9/19/2014,2815,1863,1622,241
Saturday,9/20/2014,1658,1118,985,133
Sunday,9/21/2014,2288,1656,1481,175
Monday,9/22/2014,3638,2586,2312,274
Tuesday,9/23/2014,4462,3257,2989,268
Wednesday,9/24/2014,4414,3175,2891,284
Thursday,9/25/2014,4315,3029,2743,286
Friday,9/26/2014,3323,2249,2033,216
Saturday,9/27/2014,1656,1180,1040,140
Sunday,9/28/2014,2465,1806,1613,193
Monday,9/29/2014,4096,2873,2577,296
Tuesday,9/30/2014,4474,3032,2720,312
Wednesday,10/1/2014,4124,2849,2541,308
Thursday,10/2/2014,3514,2489,2239,250
Friday,10/3/2014,3005,2097,1856,241
Saturday,10/4/2014,2054,1436,1274,162
Sunday,10/5/2014,2847,1913,1713,200
Monday,10/6/2014,4501,3181,2853,328
Tuesday,10/7/2014,4603,3163,2804,359
Wednesday,10/8/2014,4187,3014,2663,351
Thursday,10/9/2014,4343,2864,2545,319
Friday,10/10/2014,3565,2382,2100,282
Saturday,10/11/2014,2080,1457,1280,177
Sunday,10/12/2014,3031,2089,1856,233
Monday,10/13/2014,4814,3339,2973,366
Tuesday,10/14/2014,5040,3604,3217,387
Wednesday,10/15/2014,5028,3515,3094,421
Thursday,10/16/2014,4658,3331,2955,376
Friday,10/17/2014,3624,2477,2148,329
Saturday,10/18/2014,2285,1619,1416,203
Sunday,10/19/2014,3454,2346,2060,286
Monday,10/20/2014,5307,3717,3308,409
Tuesday,10/21/2014,5135,3701,3280,421
Wednesday,10/22/2014,5084,3611,3177,434
Thursday,10/23/2014,4650,3316,2940,376
Friday,10/24/2014,3571,2498,2170,328
Saturday,10/25/2014,2354,1661,1417,244
Sunday,10/26/2014,3497,2508,2218,290
Monday,10/27/2014,5294,3737,3286,451
Tuesday,10/28/2014,4643,3328,2905,423
Wednesday,10/29/2014,4596,3279,2863,416
Thursday,10/30/2014,4162,3041,2657,384
Friday,10/31/2014,2933,2007,1728,279
Saturday,11/1/2014,2202,1496,1270,226
Sunday,11/2/2014,3083,2204,1940,264
Monday,11/3/2014,4376,3057,2629,428
Tuesday,11/4/2014,4704,3141,2739,402
Wednesday,11/5/2014,4306,3200,2797,403
Thursday,11/6/2014,4178,3034,2627,407
Friday,11/7/2014,3236,2318,1975,343
Saturday,11/8/2014,2010,1536,1345,191
Sunday,11/9/2014,2901,2141,1849,292
Monday,11/10/2014,4754,3325,2885,440
Tuesday,11/11/2014,4417,3203,2793,410
Wednesday,11/12/2014,4535,3351,2897,454
Thursday,11/13/2014,4274,3194,2758,436
Friday,11/14/2014,3382,2423,2061,362
Saturday,11/15/2014,2085,1488,1280,208
Sunday,11/16/2014,3083,2215,1926,289
Monday,11/17/2014,4860,3559,3069,490
Tuesday,11/18/2014,4893,3570,3133,437
Wednesday,11/19/2014,4866,3544,3056,488
Thursday,11/20/2014,4584,3357,2899,458
Friday,11/21/2014,3914,2750,2361,389
Saturday,11/22/2014,2431,1716,1463,253
Sunday,11/23/2014,3157,2369,2082,287
Monday,11/24/2014,5045,3615,3146,469
Tuesday,11/25/2014,4746,3236,2821,415
Wednesday,11/26/2014,4314,2919,2513,406
Thursday,11/27/2014,3663,2476,2162,314
Friday,11/28/2014,3270,2268,1931,337
Saturday,11/29/2014,2905,1976,1695,281
Sunday,11/30/2014,4016,2832,2489,343
Monday,12/1/2014,5266,3877,3317,560
Tuesday,12/2/2014,5795,4274,3700,574
Wednesday,12/3/2014,5728,4217,3656,561
Thursday,12/4/2014,5293,3830,3295,535
Friday,12/5/2014,3934,2856,2479,377
Saturday,12/6/2014,3071,2165,1855,310
Sunday,12/7/2014,3876,2984,2582,402
Monday,12/8/2014,5878,4375,3829,546
Tuesday,12/9/2014,5712,4187,3635,552
Wednesday,12/10/2014,5491,4074,3480,594
Thursday,12/11/2014,5144,3801,3247,554
Friday,12/12/2014,3880,2860,2418,442
Saturday,12/13/2014,2605,1838,1538,300
Sunday,12/14/2014,3625,2650,2259,391
Monday,12/15/2014,4685,3478,3000,478
Tuesday,12/16/2014,4891,3338,2861,477
Wednesday,12/17/2014,4222,3053,2606,447
Thursday,12/18/2014,3691,2690,2275,415
Friday,12/19/2014,2748,1879,1559,320
Saturday,12/20/2014,1380,1011,836,175
Sunday,12/21/2014,1474,1054,876,178
Monday,12/22/2014,2452,1715,1394,321
Tuesday,12/23/2014,2298,1440,1159,281
Wednesday,12/24/2014,1430,947,772,175
Thursday,12/25/2014,1002,667,522,145
Friday,12/26/2014,1486,1005,808,197
Saturday,12/27/2014,1345,941,781,160
Sunday,12/28/2014,1453,948,765,183
Monday,12/29/2014,2173,1472,1228,244
Tuesday,12/30/2014,2208,1424,1172,252
Wednesday,12/31/2014,1381,955,773,182
Thursday,1/1/2015,1265,876,715,161
Friday,1/2/2015,1948,1288,1030,258
Saturday,1/3/2015,1742,1096,946,150
Sunday,1/4/2015,1896,1409,1186,223
Monday,1/5/2015,3033,2062,1706,356
Tuesday,1/6/2015,3445,2327,1942,385
Wednesday,1/7/2015,3423,2384,1991,393
Thursday,1/8/2015,3319,2272,1922,350
Friday,1/9/2015,2783,1941,1663,278
Saturday,1/10/2015,1952,1240,1066,174
Sunday,1/11/2015,2245,1611,1391,220
Monday,1/12/2015,3928,2518,2125,393
Tuesday,1/13/2015,3810,2621,2239,382
Wednesday,1/14/2015,3931,2656,2229,427
Thursday,1/15/2015,3523,2457,2069,388
Friday,1/16/2015,2943,1928,1640,288
Saturday,1/17/2015,1751,1237,1052,185
Sunday,1/18/2015,2491,1762,1541,221
Monday,1/19/2015,3766,2665,2271,394
Tuesday,1/20/2015,4194,2852,2423,429
Wednesday,1/21/2015,4038,2916,2482,434
Thursday,1/22/2015,3891,2702,2334,368
Friday,1/23/2015,3111,2181,1897,284
Saturday,1/24/2015,1946,1414,1239,175
Sunday,1/25/2015,2802,2010,1740,270
Monday,1/26/2015,3892,2841,2466,375
Tuesday,1/27/2015,4172,3003,2592,411
Wednesday,1/28/2015,4464,3280,2862,418
Thursday,1/29/2015,4377,3143,2679,464
Friday,1/30/2015,3734,2514,2129,385
Saturday,1/31/2015,2262,1657,1443,214
Sunday,2/1/2015,3050,2122,1825,297
Monday,2/2/2015,4794,3366,2867,499
Tuesday,2/3/2015,4936,3423,2922,501
Wednesday,2/4/2015,5016,3500,3023,477
Thursday,2/5/2015,4489,3170,2753,417
Friday,2/6/2015,3505,2468,2075,393
Saturday,2/7/2015,2264,1679,1437,242
Sunday,2/8/2015,3314,2435,2100,335
Monday,2/9/2015,5095,3619,3125,494
Tuesday,2/10/2015,5525,3793,3272,521
Wednesday,2/11/2015,5074,3689,3190,499
Thursday,2/12/2015,4571,3319,2810,509
Friday,2/13/2015,3570,2664,2253,411
Saturday,2/14/2015,2182,1565,1323,242
Sunday,2/15/2015,3265,2277,1935,342
Monday,2/16/2015,4670,3297,2826,471
Tuesday,2/17/2015,4764,3452,2957,495
Wednesday,2/18/2015,4943,3526,3026,500
Thursday,2/19/2015,4790,3307,2811,496
Friday,2/20/2015,3604,2621,2241,380
Saturday,2/21/2015,2455,1823,1569,254
Sunday,2/22/2015,3650,2690,2329,361
Monday,2/23/2015,5463,3975,3433,542
Tuesday,2/24/2015,5884,4112,3542,570
Wednesday,2/25/2015,5615,4019,3432,587
Thursday,2/26/2015,5289,3747,3186,561
Friday,2/27/2015,4434,2969,2486,483
Saturday,2/28/2015,2665,1977,1694,283
Sunday,3/1/2015,3907,2906,2519,387
Monday,3/2/2015,5308,3778,3222,556
Tuesday,3/3/2015,5773,4025,3490,535
Wednesday,3/4/2015,5585,4060,3457,603
Thursday,3/5/2015,4783,3582,3049,533
Friday,3/6/2015,3893,2707,2259,448
Saturday,3/7/2015,2917,2048,1723,325
Sunday,3/8/2015,3353,2468,2104,364
Monday,3/9/2015,5400,3824,3246,578
Tuesday,3/10/2015,5395,3926,3350,576
Wednesday,3/11/2015,5229,3859,3263,596
Thursday,3/12/2015,5371,3784,3204,580
Friday,3/13/2015,4185,3045,2559,486
Saturday,3/14/2015,2724,1988,1675,313
Sunday,3/15/2015,3590,2620,2196,424
Monday,3/16/2015,5367,3771,3192,579
Tuesday,3/17/2015,5440,3968,3387,581
Wednesday,3/18/2015,5465,4043,3458,585
Thursday,3/19/2015,5318,3813,3262,551
Friday,3/20/2015,4225,2916,2462,454
Saturday,3/21/2015,2687,1975,1667,308
Sunday,3/22/2015,3791,2786,2388,398
Monday,3/23/2015,5661,3949,3331,618
Tuesday,3/24/2015,5759,4081,3487,594
Wednesday,3/25/2015,5599,3983,3378,605
Thursday,3/26/2015,5103,3755,3184,571
Friday,3/27/2015,4313,2946,2446,500
Saturday,3/28/2015,2971,2011,1651,360
Sunday,3/29/2015,3662,2693,2285,408
Monday,3/30/2015,5635,3985,3386,599
Tuesday,3/31/2015,5581,3963,3359,604
Wednesday,4/1/2015,5329,3761,3170,591
Thursday,4/2/2015,4553,3214,2710,504
Friday,4/3/2015,3423,2404,1988,416
Saturday,4/4/2015,2708,1807,1512,295
Sunday,4/5/2015,3306,2266,1895,371
Monday,4/6/2015,5203,3692,3133,559
Tuesday,4/7/2015,5712,4104,3456,648
Wednesday,4/8/2015,5601,4015,3401,614
Thursday,4/9/2015,5486,4063,3430,633
Friday,4/10/2015,4178,3213,2697,516
Saturday,4/11/2015,2878,2153,1835,318
Sunday,4/12/2015,4169,2903,2447,456
Monday,4/13/2015,6372,4485,3787,698
Tuesday,4/14/2015,6240,4391,3698,693
Wednesday,4/15/2015,6170,4409,3723,686
Thursday,4/16/2015,6071,4275,3586,689
Friday,4/17/2015,4682,3307,2741,566
Saturday,4/18/2015,3208,2291,1894,397
Sunday,4/19/2015,4310,3144,2669,475
Monday,4/20/2015,6435,4694,3929,765
Tuesday,4/21/2015,6299,4455,3769,686
Wednesday,4/22/2015,6360,4512,3797,715
Thursday,4/23/2015,6349,4360,3664,696
Friday,4/24/2015,4660,3387,2845,542
Saturday,4/25/2015,3354,2420,2035,385
Sunday,4/26/2015,4371,3189,2688,501
Monday,4/27/2015,6534,4731,3977,754
Tuesday,4/28/2015,6832,4941,4161,780
Wednesday,4/29/2015,6689,4870,4110,760
Thursday,4/30/2015,5849,4086,3450,636
Friday,5/1/2015,4247,3064,2562,502
Saturday,5/2/2015,3219,2360,1958,402
Sunday,5/3/2015,4211,3210,2765,445
Monday,5/4/2015,6424,4752,4043,709
Tuesday,5/5/2015,6223,4520,3818,702
Wednesday,5/6/2015,6551,4768,4059,709
Thursday,5/7/2015,6343,4449,3770,679
Friday,5/8/2015,4696,3366,2824,542
Saturday,5/9/2015,3134,2239,1846,393
Sunday,5/10/2015,3868,2844,2365,479
Monday,5/11/2015,6020,4482,3787,695
Tuesday,5/12/2015,5705,4160,3490,670
Wednesday,5/13/2015,5752,4016,3348,668
Thursday,5/14/2015,5181,3605,3008,597
Friday,5/15/2015,4269,2913,2404,509
Saturday,5/16/2015,2633,1818,1473,345
Sunday,5/17/2015,3336,2376,1988,388
Monday,5/18/2015,5127,3587,2955,632
Tuesday,5/19/2015,5449,3767,3149,618
Wednesday,5/20/2015,5746,3956,3371,585
Thursday,5/21/2015,5115,3642,3046,596
Friday,5/22/2015,3995,2749,2243,506
Saturday,5/23/2015,2618,1884,1585,299
Sunday,5/24/2015,2961,2117,1763,354
Monday,5/25/2015,4090,2913,2427,486
Tuesday,5/26/2015,5201,3637,3073,564
Wednesday,5/27/2015,5321,3797,3146,651
Thursday,5/28/2015,5219,3509,2887,622
Friday,5/29/2015,4017,2804,2338,466
Saturday,5/30/2015,2297,1629,1346,283
Sunday,5/31/2015,3145,2226,1860,366
Monday,6/1/2015,4905,3419,2797,622
Tuesday,6/2/2015,4747,3284,2701,583
Wednesday,6/3/2015,4591,3317,2713,604
Thursday,6/4/2015,4431,3173,2652,521
Friday,6/5/2015,3608,2523,2068,455
Saturday,6/6/2015,2422,1673,1336,337
Sunday,6/7/2015,3132,2145,1790,355
Monday,6/8/2015,4962,3377,2788,589
Tuesday,6/9/2015,4881,3469,2862,607
Wednesday,6/10/2015,5001,3425,2786,639
Thursday,6/11/2015,4635,3242,2614,628
Friday,6/12/2015,3545,2494,2066,428
Saturday,6/13/2015,2262,1490,1235,255
Sunday,6/14/2015,2866,2034,1692,342
Monday,6/15/2015,4692,3261,2682,579
Tuesday,6/16/2015,4602,3204,2660,544
Wednesday,6/17/2015,4620,3101,2556,545
Thursday,6/18/2015,4475,2955,2386,569
Friday,6/19/2015,3564,2422,1954,468
Saturday,6/20/2015,2071,1370,1129,241
Sunday,6/21/2015,2659,1840,1523,317
Monday,6/22/2015,4338,2963,2410,553
Tuesday,6/23/2015,4531,3139,2566,573
Wednesday,6/24/2015,4498,3022,2481,541
Thursday,6/25/2015,4128,2730,2210,520
Friday,6/26/2015,3132,2153,1721,432
Saturday,6/27/2015,1829,1264,1067,197
Sunday,6/28/2015,2149,1517,1224,293
Monday,6/29/2015,3975,2691,2169,522
Tuesday,6/30/2015,4046,2718,2180,538
Wednesday,7/1/2015,3897,2745,2266,479
Thursday,7/2/2015,3871,2540,2072,468
Friday,7/3/2015,2630,1716,1353,363
Saturday,7/4/2015,1602,1104,900,204
Sunday,7/5/2015,1960,1370,1141,229
Monday,7/6/2015,4143,2655,2171,484
Tuesday,7/7/2015,4205,2789,2266,523
Wednesday,7/8/2015,4193,2783,2255,528
Thursday,7/9/2015,3710,2536,2069,467
Friday,7/10/2015,3137,2203,1767,436
Saturday,7/11/2015,1834,1145,944,201
Sunday,7/12/2015,2070,1473,1197,276
Monday,7/13/2015,4180,2852,2310,542
Tuesday,7/14/2015,4038,2731,2226,505
Wednesday,7/15/2015,3906,2667,2119,548
Thursday,7/16/2015,3580,2424,1940,484
Friday,7/17/2015,2948,2070,1708,362
Saturday,7/18/2015,1622,1121,924,197
Sunday,7/19/2015,2179,1480,1214,266
Monday,7/20/2015,3906,2615,2146,469
Tuesday,7/21/2015,3745,2596,2071,525
Wednesday,7/22/2015,4212,2761,2205,556
Thursday,7/23/2015,3901,2595,2095,500
Friday,7/24/2015,3292,2207,1785,422
Saturday,7/25/2015,1819,1229,1016,213
Sunday,7/26/2015,2068,1562,1286,276
Monday,7/27/2015,3991,2805,2243,562
Tuesday,7/28/2015,4073,2862,2361,501
Wednesday,7/29/2015,4069,2825,2324,501
Thursday,7/30/2015,3716,2629,2126,503
Friday,7/31/2015,3380,2120,1709,411
Saturday,8/1/2015,1737,1197,958,239
Sunday,8/2/2015,2181,1567,1282,285
Monday,8/3/2015,3973,2794,2263,531
Tuesday,8/4/2015,3997,2794,2269,525
Wednesday,8/5/2015,4132,2798,2287,511
Thursday,8/6/2015,3791,2693,2204,489
Friday,8/7/2015,2968,2139,1738,401
Saturday,8/8/2015,1752,1266,1021,245
Sunday,8/9/2015,2070,1497,1231,266
Monday,8/10/2015,3920,2684,2139,545
Tuesday,8/11/2015,4106,2791,2266,525
Wednesday,8/12/2015,4006,2726,2166,560
Thursday,8/13/2015,3827,2639,2133,506
Friday,8/14/2015,2944,1973,1564,409
Saturday,8/15/2015,1827,1193,954,239
Sunday,8/16/2015,2373,1658,1369,289
Monday,8/17/2015,4031,2763,2290,473
Tuesday,8/18/2015,4027,2780,2248,532
Wednesday,8/19/2015,3912,2795,2291,504
Thursday,8/20/2015,3867,2715,2191,524
Friday,8/21/2015,3304,2238,1806,432
Saturday,8/22/2015,1685,1208,1011,197
Sunday,8/23/2015,2130,1542,1282,260
Monday,8/24/2015,3936,2697,2182,515
Tuesday,8/25/2015,4029,2744,2203,541
Wednesday,8/26/2015,4010,2789,2237,552
Thursday,8/27/2015,4027,2890,2392,498
Friday,8/28/2015,2829,2000,1585,415
Saturday,8/29/2015,1736,1227,1023,204
Sunday,8/30/2015,2517,1686,1416,270
Monday,8/31/2015,4029,2769,2299,470
Tuesday,9/1/2015,4261,2890,2358,532
Wednesday,9/2/2015,4058,2923,2442,481
Thursday,9/3/2015,4392,3007,2466,541
Friday,9/4/2015,3072,2221,1846,375
Saturday,9/5/2015,1799,1284,1068,216
Sunday,9/6/2015,2341,1611,1345,266
Monday,9/7/2015,3330,2354,1963,391
Tuesday,9/8/2015,4734,3381,2833,548
Wednesday,9/9/2015,4801,3381,2845,536
Thursday,9/10/2015,4399,3079,2575,504
Friday,9/11/2015,3275,2375,1958,417
Saturday,9/12/2015,2042,1429,1223,206
Sunday,9/13/2015,2827,2103,1844,259
Monday,9/14/2015,4836,3437,2954,483
Tuesday,9/15/2015,4840,3465,2944,521
Wednesday,9/16/2015,4504,3356,2902,454
Thursday,9/17/2015,4379,3240,2736,504
Friday,9/18/2015,3391,2428,2024,404
Saturday,9/19/2015,2045,1513,1278,235
Sunday,9/20/2015,2721,2081,1817,264
Monday,9/21/2015,4630,3535,2998,537
Tuesday,9/22/2015,4748,3540,3004,536
Wednesday,9/23/2015,4702,3377,2893,484
Thursday,9/24/2015,4440,3309,2827,482
Friday,9/25/2015,3513,2518,2116,402
Saturday,9/26/2015,2253,1633,1395,238
Sunday,9/27/2015,3141,2291,1980,311
Monday,9/28/2015,5122,3808,3289,519
Tuesday,9/29/2015,5151,3868,3305,563
Wednesday,9/30/2015,4969,3703,3182,521
Thursday,10/1/2015,4619,3365,2876,489
Friday,10/2/2015,3443,2598,2196,402
Saturday,10/3/2015,2302,1754,1503,251
Sunday,10/4/2015,3291,2506,2173,333
Monday,10/5/2015,5206,3737,3170,567
Tuesday,10/6/2015,5474,3940,3337,603
Wednesday,10/7/2015,5400,3934,3350,584
Thursday,10/8/2015,5334,3821,3244,577
Friday,10/9/2015,4174,3022,2547,475
Saturday,10/10/2015,2571,1853,1597,256
Sunday,10/11/2015,3572,2636,2283,353
Monday,10/12/2015,5018,3788,3241,547
Tuesday,10/13/2015,5565,4159,3536,623
Wednesday,10/14/2015,5420,4048,3403,645
Thursday,10/15/2015,5366,3908,3331,577
Friday,10/16/2015,4091,3002,2507,495
Saturday,10/17/2015,2824,2087,1770,317
Sunday,10/18/2015,3843,2825,2441,384
Monday,10/19/2015,5516,4140,3491,649
Tuesday,10/20/2015,5572,4121,3460,661
Wednesday,10/21/2015,5243,3882,3298,584
Thursday,10/22/2015,5133,3720,3104,616
Friday,10/23/2015,4084,2947,2441,506
Saturday,10/24/2015,2739,1978,1647,331
Sunday,10/25/2015,3781,2857,2435,422
Monday,10/26/2015,5684,4073,3417,656
Tuesday,10/27/2015,5687,4179,3534,645
Wednesday,10/28/2015,5906,4266,3614,652
Thursday,10/29/2015,5541,4020,3368,652
Friday,10/30/2015,4171,3043,2501,542
Saturday,10/31/2015,2586,1820,1496,324
Sunday,11/1/2015,3838,2922,2456,466
Monday,11/2/2015,5675,4076,3419,657
Tuesday,11/3/2015,5624,4178,3504,674
Wednesday,11/4/2015,5794,4316,3670,646
Thursday,11/5/2015,5389,4031,3379,652
Friday,11/6/2015,4305,3047,2522,525
Saturday,11/7/2015,3281,2202,1854,348
Sunday,11/8/2015,3790,2837,2418,419
Monday,11/9/2015,5894,4203,3487,716
Tuesday,11/10/2015,5461,4048,3388,660
Wednesday,11/11/2015,5206,3869,3219,650
Thursday,11/12/2015,5228,3929,3281,648
Friday,11/13/2015,4097,2971,2436,535
Saturday,11/14/2015,2694,1964,1616,348
Sunday,11/15/2015,3893,2930,2483,447
Monday,11/16/2015,6185,4550,3872,678
Tuesday,11/17/2015,6178,4503,3795,708
Wednesday,11/18/2015,6067,4397,3693,704
Thursday,11/19/2015,5656,4166,3487,679
Friday,11/20/2015,4398,3173,2645,528
Saturday,11/21/2015,2836,2086,1741,345
Sunday,11/22/2015,3896,2927,2424,503
Monday,11/23/2015,5814,4236,3543,693
Tuesday,11/24/2015,5879,4140,3475,665
Wednesday,11/25/2015,4800,3457,2836,621
Thursday,11/26/2015,3838,2825,2334,491
Friday,11/27/2015,3576,2579,2118,461
Saturday,11/28/2015,2799,1974,1652,322
Sunday,11/29/2015,4228,3127,2605,522
Monday,11/30/2015,6331,4570,3817,753
Tuesday,12/1/2015,6380,4743,4027,716
Wednesday,12/2/2015,6314,4829,4039,790
Thursday,12/3/2015,6160,4584,3835,749
Friday,12/4/2015,4859,3615,2995,620
Saturday,12/5/2015,3317,2468,2040,428
Sunday,12/6/2015,4715,3550,2972,578
Monday,12/7/2015,6940,5136,4303,833
Tuesday,12/8/2015,6551,4866,4068,798
Wednesday,12/9/2015,6327,4761,3961,800
Thursday,12/10/2015,6212,4578,3830,748
Friday,12/11/2015,4687,3388,2771,617
Saturday,12/12/2015,3014,2283,1856,427
Sunday,12/13/2015,4132,3064,2548,516
Monday,12/14/2015,5989,4330,3606,724
Tuesday,12/15/2015,5331,3967,3309,658
Wednesday,12/16/2015,5183,3665,3025,640
Thursday,12/17/2015,4769,3515,2917,598
Friday,12/18/2015,3627,2518,2071,447
Saturday,12/19/2015,1857,1319,1087,232
Sunday,12/20/2015,2221,1489,1204,285
Monday,12/21/2015,3335,2335,1906,429
Tuesday,12/22/2015,2883,2047,1639,408
Wednesday,12/23/2015,2353,1621,1312,309
Thursday,12/24/2015,1578,1099,886,213
Friday,12/25/2015,1017,724,586,138
Saturday,12/26/2015,1334,936,760,176
Sunday,12/27/2015,1690,1155,947,208
Monday,12/28/2015,2838,1829,1474,355
Tuesday,12/29/2015,2815,1786,1419,367
Wednesday,12/30/2015,2382,1618,1292,326
Thursday,12/31/2015,1587,1035,809,226
Friday,1/1/2016,1411,960,786,174
Saturday,1/2/2016,1838,1197,969,228
Sunday,1/3/2016,2180,1562,1279,283
Monday,1/4/2016,3587,2494,2037,457
Tuesday,1/5/2016,3855,2742,2230,512
Wednesday,1/6/2016,3840,2628,2127,501
Thursday,1/7/2016,3735,2746,2258,488
Friday,1/8/2016,3223,2286,1860,426
Saturday,1/9/2016,2207,1531,1280,251
Sunday,1/10/2016,2814,2000,1661,339
Monday,1/11/2016,4007,2976,2444,532
Tuesday,1/12/2016,4119,2961,2385,576
Wednesday,1/13/2016,4338,3164,2631,533
Thursday,1/14/2016,4432,2962,2418,544
Friday,1/15/2016,3306,2349,1866,483
Saturday,1/16/2016,2223,1557,1262,295
Sunday,1/17/2016,2757,2002,1635,367
Monday,1/18/2016,4047,2898,2373,525
Tuesday,1/19/2016,4489,3190,2566,624
Wednesday,1/20/2016,4588,3232,2656,576
Thursday,1/21/2016,4398,3106,2561,545
Friday,1/22/2016,3340,2455,1990,465
Saturday,1/23/2016,2344,1639,1338,301
Sunday,1/24/2016,2973,2094,1736,358
Monday,1/25/2016,4638,3205,2649,556
Tuesday,1/26/2016,4791,3409,2834,575
Wednesday,1/27/2016,5104,3768,3197,571
Thursday,1/28/2016,4621,3439,2876,563
Friday,1/29/2016,3831,2715,2232,483
Saturday,1/30/2016,2295,1690,1400,290
Sunday,1/31/2016,3235,2462,2050,412
Monday,2/1/2016,4918,3640,3060,580
Tuesday,2/2/2016,5127,3783,3195,588
Wednesday,2/3/2016,4794,3575,2999,576
Thursday,2/4/2016,4788,3420,2848,572
Friday,2/5/2016,3948,2727,2256,471
Saturday,2/6/2016,2383,1765,1477,288
Sunday,2/7/2016,2950,2231,1839,392
Monday,2/8/2016,4905,3592,3024,568
Tuesday,2/9/2016,5353,3931,3299,632
Wednesday,2/10/2016,5492,4007,3358,649
Thursday,2/11/2016,5052,3628,3019,609
Friday,2/12/2016,3764,2807,2300,507
Saturday,2/13/2016,2458,1788,1459,329
Sunday,2/14/2016,3098,2277,1866,411
Monday,2/15/2016,4951,3652,3039,613
Tuesday,2/16/2016,5495,4000,3304,696
Wednesday,2/17/2016,5505,4062,3375,687
Thursday,2/18/2016,5188,3812,3156,656
Friday,2/19/2016,4002,2932,2377,555
Saturday,2/20/2016,2607,1888,1537,351
Sunday,2/21/2016,3906,2838,2355,483
Monday,2/22/2016,6360,4432,3684,748
Tuesday,2/23/2016,6046,4460,3714,746
Wednesday,2/24/2016,5938,4309,3499,810
Thursday,2/25/2016,5325,3892,3199,693
Friday,2/26/2016,4165,3048,2490,558
Saturday,2/27/2016,2829,2096,1726,370
Sunday,2/28/2016,4090,2979,2462,517
Monday,2/29/2016,5734,4224,3493,731
Tuesday,3/1/2016,6214,4474,3731,743
Wednesday,3/2/2016,5906,4333,3597,736
Thursday,3/3/2016,5814,4191,3419,772
Friday,3/4/2016,4507,3188,2624,564
Saturday,3/5/2016,2859,2064,1718,346
Sunday,3/6/2016,3897,2806,2326,480
Monday,3/7/2016,5849,4240,3503,737
Tuesday,3/8/2016,6264,4526,3743,783
Wednesday,3/9/2016,6062,4404,3624,780
Thursday,3/10/2016,5685,4159,3415,744
Friday,3/11/2016,4391,3241,2627,614
Saturday,3/12/2016,2880,2046,1638,408
Sunday,3/13/2016,3740,2673,2163,510
Monday,3/14/2016,5710,4261,3469,792
Tuesday,3/15/2016,5168,3778,3047,731
Wednesday,3/16/2016,5577,4062,3287,775
Thursday,3/17/2016,5238,3827,3134,693
Friday,3/18/2016,3931,2871,2320,551
Saturday,3/19/2016,2606,1892,1568,324
Sunday,3/20/2016,3149,2410,2028,382
Monday,3/21/2016,5565,3968,3274,694
Tuesday,3/22/2016,5281,3770,3035,735
Wednesday,3/23/2016,5202,3780,3146,634
Thursday,3/24/2016,4581,3203,2649,554
Friday,3/25/2016,3264,2281,1847,434
Saturday,3/26/2016,2344,1759,1393,366
Sunday,3/27/2016,3112,2311,1890,421
Monday,3/28/2016,5051,3655,2985,670
Tuesday,3/29/2016,5333,3944,3217,727
Wednesday,3/30/2016,5671,4078,3369,709
Thursday,3/31/2016,5097,3707,3026,681
Friday,4/1/2016,4555,2971,2408,563
Saturday,4/2/2016,2987,2129,1737,392
Sunday,4/3/2016,4257,2964,2421,543
Monday,4/4/2016,5804,4216,3426,790
Tuesday,4/5/2016,5885,4379,3597,782
Wednesday,4/6/2016,6054,4293,3522,771
Thursday,4/7/2016,5791,4147,3422,725
Friday,4/8/2016,4741,3430,2820,610
Saturday,4/9/2016,2946,2140,1740,400
Sunday,4/10/2016,4071,2864,2330,534
Monday,4/11/2016,6265,4503,3667,836
Tuesday,4/12/2016,6298,4626,3769,857
Wednesday,4/13/2016,6495,4628,3791,837
Thursday,4/14/2016,5536,4189,3431,758
Friday,4/15/2016,4737,3447,2785,662
Saturday,4/16/2016,3232,2333,1862,471
Sunday,4/17/2016,4201,3093,2504,589
Monday,4/18/2016,6806,4769,3920,849
Tuesday,4/19/2016,6769,4817,3940,877
Wednesday,4/20/2016,6581,4824,3926,898
Thursday,4/21/2016,6254,4537,3707,830
Friday,4/22/2016,5163,3685,3009,676
Saturday,4/23/2016,3851,2595,2113,482
Sunday,4/24/2016,4695,3386,2761,625
Monday,4/25/2016,7098,5224,4237,987
Tuesday,4/26/2016,7156,5392,4468,924
Wednesday,4/27/2016,6836,5056,4130,926
Thursday,4/28/2016,6329,4724,3892,832
Friday,4/29/2016,4990,3608,2922,686
Saturday,4/30/2016,3536,2489,1993,496
Sunday,5/1/2016,4366,3236,2605,631
Monday,5/2/2016,6510,4786,3909,877
Tuesday,5/3/2016,6855,4962,4085,877
Wednesday,5/4/2016,6599,4651,3744,907
Thursday,5/5/2016,5510,4105,3375,730
Friday,5/6/2016,4549,3245,2639,606
Saturday,5/7/2016,3064,2167,1760,407
Sunday,5/8/2016,3633,2663,2180,483
Monday,5/9/2016,5838,4283,3489,794
Tuesday,5/10/2016,6026,4336,3581,755
Wednesday,5/11/2016,5780,4226,3479,747
Thursday,5/12/2016,5131,3781,3101,680
Friday,5/13/2016,3928,2845,2294,551
Saturday,5/14/2016,2636,1930,1552,378
Sunday,5/15/2016,3278,2366,1922,444
Monday,5/16/2016,4785,3560,2882,678
Tuesday,5/17/2016,4886,3601,2914,687
Wednesday,5/18/2016,5145,3672,2987,685
Thursday,5/19/2016,5849,4211,3484,727
Friday,5/20/2016,4456,3324,2725,599
Saturday,5/21/2016,2960,2138,1716,422
Sunday,5/22/2016,3885,2860,2338,522
Monday,5/23/2016,5857,4155,3368,787
Tuesday,5/24/2016,6162,4345,3526,819
Wednesday,5/25/2016,6014,4254,3398,856
Thursday,5/26/2016,5652,4119,3385,734
Friday,5/27/2016,4793,3340,2692,648
Saturday,5/28/2016,2819,1995,1611,384
Sunday,5/29/2016,3687,2546,2067,479
Monday,5/30/2016,4851,3399,2701,698
Tuesday,5/31/2016,5775,4216,3413,803
Wednesday,6/1/2016,5443,3962,3193,769
Thursday,6/2/2016,5590,3959,3176,783
Friday,6/3/2016,4482,3164,2489,675
Saturday,6/4/2016,2792,1947,1533,414
Sunday,6/5/2016,3371,2449,1979,470
Monday,6/6/2016,5547,3832,3036,796
Tuesday,6/7/2016,5468,3954,3226,728
Wednesday,6/8/2016,5104,3751,3064,687
Thursday,6/9/2016,4728,3485,2812,673
Friday,6/10/2016,4024,2855,2290,565
Saturday,6/11/2016,2350,1677,1348,329
Sunday,6/12/2016,3234,2196,1779,417
Monday,6/13/2016,4948,3550,2790,760
Tuesday,6/14/2016,5247,3760,3052,708
Wednesday,6/15/2016,5003,3557,2810,747
Thursday,6/16/2016,4816,3482,2775,707
Friday,6/17/2016,4208,2818,2267,551
Saturday,6/18/2016,2454,1668,1357,311
Sunday,6/19/2016,2763,1919,1506,413
Monday,6/20/2016,4954,3522,2829,693
Tuesday,6/21/2016,4903,3470,2793,677
Wednesday,6/22/2016,4907,3464,2772,692
Thursday,6/23/2016,4625,3336,2669,667
Friday,6/24/2016,3497,2482,1947,535
Saturday,6/25/2016,1826,1358,1101,257
Sunday,6/26/2016,2307,1721,1356,365
Monday,6/27/2016,4368,3078,2433,645
Tuesday,6/28/2016,4233,3091,2466,625
Wednesday,6/29/2016,4187,2948,2377,571
Thursday,6/30/2016,3811,2726,2135,591
Friday,7/1/2016,3179,2226,1730,496
Saturday,7/2/2016,1615,1039,814,225
Sunday,7/3/2016,1788,1307,1028,279
Monday,7/4/2016,2959,2144,1653,491
Tuesday,7/5/2016,3947,2840,2235,605
Wednesday,7/6/2016,3841,2821,2248,573
Thursday,7/7/2016,3729,2700,2148,552
Friday,7/8/2016,3324,2381,1891,490
Saturday,7/9/2016,1795,1305,1036,269
Sunday,7/10/2016,2373,1655,1321,334
Monday,7/11/2016,4101,2855,2208,647
Tuesday,7/12/2016,4241,2960,2352,608
Wednesday,7/13/2016,4478,3189,2578,611
Thursday,7/14/2016,3961,2814,2214,600
Friday,7/15/2016,3367,2325,1796,529
Saturday,7/16/2016,1828,1222,951,271
Sunday,7/17/2016,2344,1636,1319,317
Monday,7/18/2016,4415,3007,2382,625
Tuesday,7/19/2016,4403,3151,2502,649
Wednesday,7/20/2016,4244,3082,2450,632
Thursday,7/21/2016,4322,3077,2404,673
Friday,7/22/2016,3456,2431,1936,495
Saturday,7/23/2016,2068,1407,1099,308
Sunday,7/24/2016,2568,1755,1374,381
Monday,7/25/2016,4770,3320,2628,692
Tuesday,7/26/2016,4621,3277,2595,682
Wednesday,7/27/2016,4470,3164,2513,651
Thursday,7/28/2016,4307,3077,2459,618
Friday,7/29/2016,3370,2366,1818,548
Saturday,7/30/2016,1960,1341,1017,324
Sunday,7/31/2016,2412,1765,1423,342
Monday,8/1/2016,4504,3095,2489,606
Tuesday,8/2/2016,4382,3138,2499,639
Wednesday,8/3/2016,4710,3369,2697,672
Thursday,8/4/2016,4324,3106,2479,627
Friday,8/5/2016,3472,2497,1980,517
Saturday,8/6/2016,1909,1339,1081,258
Sunday,8/7/2016,2365,1688,1334,354
Monday,8/8/2016,4460,3056,2438,618
Tuesday,8/9/2016,4479,3135,2482,653
Wednesday,8/10/2016,4510,3207,2550,657
Thursday,8/11/2016,4340,3111,2491,620
Friday,8/12/2016,3508,2436,1933,503
Saturday,8/13/2016,2030,1420,1122,298
Sunday,8/14/2016,2586,1749,1399,350
Monday,8/15/2016,4476,2970,2346,624
Tuesday,8/16/2016,3232,2299,1823,476
Wednesday,8/17/2016,4291,3106,2498,608
Thursday,8/18/2016,4247,2926,2327,599
Friday,8/19/2016,3477,2539,2045,494
Saturday,8/20/2016,2169,1470,1169,301
Sunday,8/21/2016,2430,1808,1453,355
Monday,8/22/2016,4358,3082,2439,643
Tuesday,8/23/2016,4465,3249,2550,699
Wednesday,8/24/2016,4550,3210,2615,595
Thursday,8/25/2016,4147,3011,2380,631
Friday,8/26/2016,3634,2532,2000,532
Saturday,8/27/2016,2014,1430,1141,289
Sunday,8/28/2016,2687,1910,1555,355
Monday,8/29/2016,4376,3115,2521,594
Tuesday,8/30/2016,4318,3226,2622,604
Wednesday,8/31/2016,4441,3219,2620,599
Thursday,9/1/2016,4234,3116,2556,560
Friday,9/2/2016,3027,2230,1762,468
Saturday,9/3/2016,1966,1376,1101,275
Sunday,9/4/2016,2446,1761,1452,309
Monday,9/5/2016,3779,2643,2145,498
Tuesday,9/6/2016,4619,3341,2727,614
Wednesday,9/7/2016,4983,3584,2925,659
Thursday,9/8/2016,4645,3319,2716,603
Friday,9/9/2016,3612,2630,2139,491
Saturday,9/10/2016,2153,1577,1323,254
Sunday,9/11/2016,3089,2307,1978,329
Monday,9/12/2016,4580,3446,2882,564
Tuesday,9/13/2016,4788,3625,2992,633
Wednesday,9/14/2016,5095,3759,3113,646
Thursday,9/15/2016,4668,3454,2860,594
Friday,9/16/2016,3711,2785,2272,513
Saturday,9/17/2016,2523,1861,1577,284
Sunday,9/18/2016,3364,2547,2122,425
Monday,9/19/2016,5513,4050,3321,729
Tuesday,9/20/2016,5362,3762,3095,667
Wednesday,9/21/2016,5402,3987,3293,694
Thursday,9/22/2016,5398,3996,3299,697
Friday,9/23/2016,3783,2663,2134,529
Saturday,9/24/2016,2395,1797,1503,294
Sunday,9/25/2016,3679,2719,2289,430
Monday,9/26/2016,5688,4325,3570,755
Tuesday,9/27/2016,5842,4382,3645,737
Wednesday,9/28/2016,5923,4458,3682,776
Thursday,9/29/2016,5717,4222,3487,735
Friday,9/30/2016,4250,3176,2565,611
Saturday,10/1/2016,2525,1986,1656,330
Sunday,10/2/2016,3923,3023,2559,464
Monday,10/3/2016,5785,4281,3545,736
Tuesday,10/4/2016,6052,4522,3780,742
Wednesday,10/5/2016,6150,4588,3814,774
Thursday,10/6/2016,5591,4134,3419,715
Friday,10/7/2016,4279,3196,2616,580
Saturday,10/8/2016,2897,2066,1717,349
Sunday,10/9/2016,3904,2873,2374,499
Monday,10/10/2016,5458,4145,3442,703
Tuesday,10/11/2016,5909,4399,3685,714
Wednesday,10/12/2016,6175,4620,3823,797
Thursday,10/13/2016,5856,4422,3581,841
Friday,10/14/2016,4610,3505,2837,668
Saturday,10/15/2016,3081,2269,1864,405
Sunday,10/16/2016,4390,3265,2718,547
Monday,10/17/2016,6507,4917,4018,899
Tuesday,10/18/2016,6941,5103,4189,914
Wednesday,10/19/2016,6576,4776,3961,815
Thursday,10/20/2016,5985,4462,3701,761
Friday,10/21/2016,4789,3497,2840,657
Saturday,10/22/2016,3263,2292,1881,411
Sunday,10/23/2016,4180,3135,2561,574
Monday,10/24/2016,6371,4865,3993,872
Tuesday,10/25/2016,6648,4960,4070,890
Wednesday,10/26/2016,6501,4777,3880,897
Thursday,10/27/2016,6088,4431,3574,857
Friday,10/28/2016,4376,3179,2510,669
Saturday,10/29/2016,2733,1955,1549,406
Sunday,10/30/2016,3953,2921,2344,577
Monday,10/31/2016,6108,4416,3563,853
Tuesday,11/1/2016,5668,4185,3360,825
Wednesday,11/2/2016,6159,4508,3663,845
Thursday,11/3/2016,5810,4241,3426,815
Friday,11/4/2016,4491,3394,2670,724
Saturday,11/5/2016,3110,2263,1842,421
Sunday,11/6/2016,4418,3281,2713,568
Monday,11/7/2016,6529,4488,3573,915
Tuesday,11/8/2016,5756,4251,3437,814
Wednesday,11/9/2016,5716,4102,3315,787
Thursday,11/10/2016,5323,4022,3246,776
Friday,11/11/2016,4280,3085,2441,644
Saturday,11/12/2016,2982,2169,1777,392
Sunday,11/13/2016,4365,3172,2595,577
Monday,11/14/2016,6627,4888,3942,946
Tuesday,11/15/2016,6467,4808,3905,903
Wednesday,11/16/2016,6631,4903,3984,919
Thursday,11/17/2016,6378,4681,3779,902
Friday,11/18/2016,4767,3424,2734,690
Saturday,11/19/2016,3501,2580,2136,444
Sunday,11/20/2016,4647,3426,2777,649
Monday,11/21/2016,6336,4693,3788,905
Tuesday,11/22/2016,6222,4564,3646,918
Wednesday,11/23/2016,5527,3904,3082,822
Thursday,11/24/2016,4267,3197,2561,636
Friday,11/25/2016,3733,2678,2135,543
Saturday,11/26/2016,3299,2394,1907,487
Sunday,11/27/2016,4530,3396,2722,674
Monday,11/28/2016,6908,5047,4167,880
Tuesday,11/29/2016,7714,5338,4369,969
Wednesday,11/30/2016,7490,5425,4389,1036
Thursday,12/1/2016,7190,5081,4120,961
Friday,12/2/2016,5391,3977,3171,806
Saturday,12/3/2016,3575,2667,2178,489
Sunday,12/4/2016,5285,4031,3247,784
Monday,12/5/2016,7330,5439,4452,987
Tuesday,12/6/2016,7489,5479,4500,979
Wednesday,12/7/2016,7345,5467,4469,998
Thursday,12/8/2016,6679,4991,3998,993
Friday,12/9/2016,5403,3970,3190,780
Saturday,12/10/2016,3573,2712,2203,509
Sunday,12/11/2016,4834,3515,2838,677
Monday,12/12/2016,6905,4945,3988,957
Tuesday,12/13/2016,6743,4927,3942,985
Wednesday,12/14/2016,6201,4488,3593,895
Thursday,12/15/2016,5571,4071,3229,842
Friday,12/16/2016,3872,2780,2191,589
Saturday,12/17/2016,2613,1884,1480,404
Sunday,12/18/2016,3109,2293,1853,440
Monday,12/19/2016,4324,3145,2477,668
Tuesday,12/20/2016,4226,3064,2339,725
Wednesday,12/21/2016,3991,2914,2278,636
Thursday,12/22/2016,3160,2211,1728,483
Friday,12/23/2016,2386,1626,1257,369
Saturday,12/24/2016,1115,825,634,191
Sunday,12/25/2016,1387,930,740,190
Monday,12/26/2016,2147,1418,1142,276
Tuesday,12/27/2016,2686,1777,1349,428
Wednesday,12/28/2016,2885,1915,1476,439
Thursday,12/29/2016,2694,1837,1400,437
Friday,12/30/2016,2273,1541,1164,377
Saturday,12/31/2016,1188,836,643,193
Sunday,1/1/2017,1447,1039,832,207
Monday,1/2/2017,2568,1844,1448,396
Tuesday,1/3/2017,3566,2527,1970,557
Wednesday,1/4/2017,3941,2816,2226,590
Thursday,1/5/2017,3841,2625,2058,567
Friday,1/6/2017,3261,2338,1812,526
Saturday,1/7/2017,2241,1523,1204,319
Sunday,1/8/2017,2679,1892,1519,373
Monday,1/9/2017,4182,2841,2191,650
Tuesday,1/10/2017,4236,3039,2391,648
Wednesday,1/11/2017,4628,3206,2536,670
Thursday,1/12/2017,4205,3025,2403,622
Friday,1/13/2017,3459,2508,2033,475
Saturday,1/14/2017,2448,1744,1390,354
Sunday,1/15/2017,2853,2015,1586,429
Monday,1/16/2017,4638,3178,2543,635
Tuesday,1/17/2017,5325,3669,2942,727
Wednesday,1/18/2017,4866,3364,2670,694
Thursday,1/19/2017,4715,3375,2689,686
Friday,1/20/2017,3753,2713,2136,577
Saturday,1/21/2017,2481,1778,1437,341
Sunday,1/22/2017,3233,2401,1981,420
Monday,1/23/2017,5034,3660,2957,703
Tuesday,1/24/2017,4787,3593,2909,684
Wednesday,1/25/2017,4901,3602,2923,679
Thursday,1/26/2017,4398,3266,2653,613
Friday,1/27/2017,3823,2832,2267,565
Saturday,1/28/2017,2619,1901,1534,367
Sunday,1/29/2017,3518,2612,2205,407
Monday,1/30/2017,5178,3826,3127,699
Tuesday,1/31/2017,5290,3876,3127,749
Wednesday,2/1/2017,5469,4116,3402,714
Thursday,2/2/2017,5399,4028,3303,725
Friday,2/3/2017,4232,3012,2342,670
Saturday,2/4/2017,2828,2084,1697,387
Sunday,2/5/2017,3724,2783,2281,502
Monday,2/6/2017,5733,4249,3448,801
Tuesday,2/7/2017,5814,4284,3521,763
Wednesday,2/8/2017,5349,4006,3248,758
Thursday,2/9/2017,5025,3681,3010,671
Friday,2/10/2017,4044,2922,2335,587
Saturday,2/11/2017,2323,1731,1377,354
Sunday,2/12/2017,3147,2469,2005,464
Monday,2/13/2017,4972,3719,3014,705
Tuesday,2/14/2017,4878,3582,2897,685
Wednesday,2/15/2017,5288,3786,3039,747
Thursday,2/16/2017,4968,3668,2934,734
Friday,2/17/2017,3788,2748,2158,590
Saturday,2/18/2017,2514,1839,1496,343
Sunday,2/19/2017,3463,2602,2083,519
Monday,2/20/2017,4931,3700,3009,691
Tuesday,2/21/2017,5101,3873,3079,794
Wednesday,2/22/2017,5144,3727,2998,729
Thursday,2/23/2017,4433,3372,2657,715
Friday,2/24/2017,3597,2648,2111,537
Saturday,2/25/2017,2621,1826,1482,344
Sunday,2/26/2017,3397,2494,2021,473
Monday,2/27/2017,5062,3812,3009,803
Tuesday,2/28/2017,4926,3678,2933,745
Wednesday,3/1/2017,4936,3558,2822,736
Thursday,3/2/2017,4688,3441,2747,694
Friday,3/3/2017,3827,2699,2140,559
Saturday,3/4/2017,2452,1754,1408,346
Sunday,3/5/2017,3283,2394,1958,436
Monday,3/6/2017,4823,3481,2764,717
Tuesday,3/7/2017,4821,3662,2942,720
Wednesday,3/8/2017,5059,3613,2923,690
Thursday,3/9/2017,4585,3444,2744,700
Friday,3/10/2017,3682,2733,2178,555
Saturday,3/11/2017,2350,1714,1351,363
Sunday,3/12/2017,3056,2189,1755,434
Monday,3/13/2017,4746,3367,2721,646
Tuesday,3/14/2017,4613,3465,2808,657
Wednesday,3/15/2017,4560,3441,2694,747
Thursday,3/16/2017,4520,3304,2629,675
Friday,3/17/2017,3346,2433,1930,503
Saturday,3/18/2017,2253,1649,1325,324
Sunday,3/19/2017,2927,2267,1807,460
Monday,3/20/2017,4878,3463,2799,664
Tuesday,3/21/2017,4852,3481,2802,679
Wednesday,3/22/2017,4585,3430,2757,673
Thursday,3/23/2017,4477,3260,2600,660
Friday,3/24/2017,3654,2566,1993,573
Saturday,3/25/2017,2411,1760,1420,340
Sunday,3/26/2017,3054,2336,1882,454
Monday,3/27/2017,4696,3479,2765,714
Tuesday,3/28/2017,5033,3633,2875,758
Wednesday,3/29/2017,4948,3530,2809,721
Thursday,3/30/2017,4636,3390,2704,686
Friday,3/31/2017,3539,2636,2060,576
Saturday,4/1/2017,2371,1678,1338,340
Sunday,4/2/2017,2816,2159,1715,444
Monday,4/3/2017,4493,3356,2672,684
Tuesday,4/4/2017,4678,3486,2739,747
Wednesday,4/5/2017,4737,3484,2762,722
Thursday,4/6/2017,4775,3514,2806,708
Friday,4/7/2017,3658,2725,2181,544
Saturday,4/8/2017,2260,1664,1324,340
Sunday,4/9/2017,3343,2433,1933,500
Monday,4/10/2017,4640,3440,2756,684
Tuesday,4/11/2017,4694,3532,2867,665
Wednesday,4/12/2017,4771,3517,2800,717
Thursday,4/13/2017,4173,3017,2395,622
Friday,4/14/2017,3046,2238,1752,486
Saturday,4/15/2017,2260,1701,1333,368
Sunday,4/16/2017,2876,2143,1700,443
Monday,4/17/2017,4774,3402,2719,683
Tuesday,4/18/2017,5009,3702,2906,796
Wednesday,4/19/2017,5369,3852,3133,719
Thursday,4/20/2017,5020,3669,2969,700
Friday,4/21/2017,3935,2802,2203,599
Saturday,4/22/2017,2795,2049,1630,419
Sunday,4/23/2017,3795,2827,2305,522
Monday,4/24/2017,5489,4083,3252,831
Tuesday,4/25/2017,5680,4108,3336,772
Wednesday,4/26/2017,5383,3940,3205,735
Thursday,4/27/2017,4890,3695,2985,710
Friday,4/28/2017,3872,2887,2310,577
Saturday,4/29/2017,2790,1987,1602,385
Sunday,4/30/2017,3524,2616,2118,498
Monday,5/1/2017,4903,3551,2875,676
Tuesday,5/2/2017,5160,3802,3079,723
Wednesday,5/3/2017,5194,3766,2995,771
Thursday,5/4/2017,5142,3755,3013,742
Friday,5/5/2017,3836,2925,2323,602
Saturday,5/6/2017,2737,1981,1572,409
Sunday,5/7/2017,3386,2534,2025,509
Monday,5/8/2017,4816,3585,2900,685
Tuesday,5/9/2017,4734,3458,2763,695
Wednesday,5/10/2017,4761,3475,2754,721
Thursday,5/11/2017,4277,3224,2570,654
Friday,5/12/2017,3563,2620,2056,564
Saturday,5/13/2017,2401,1749,1379,370
Sunday,5/14/2017,2877,2126,1674,452
Monday,5/15/2017,4448,3191,2494,697
Tuesday,5/16/2017,4525,3226,2593,633
Wednesday,5/17/2017,4533,3318,2676,642
Thursday,5/18/2017,4431,3307,2686,621
Friday,5/19/2017,3456,2470,1938,532
Saturday,5/20/2017,2162,1651,1332,319
Sunday,5/21/2017,2786,1971,1597,374
Monday,5/22/2017,4172,3041,2403,638
Tuesday,5/23/2017,4255,3077,2457,620
Wednesday,5/24/2017,4154,2996,2400,596
Thursday,5/25/2017,3803,2839,2263,576
Friday,5/26/2017,2950,2183,1720,463
Saturday,5/27/2017,1909,1444,1155,289
Sunday,5/28/2017,2506,1781,1399,382
Monday,5/29/2017,3325,2457,1913,544
Tuesday,5/30/2017,4086,2909,2298,611
Wednesday,5/31/2017,3716,2667,2069,598
Thursday,6/1/2017,3702,2639,2103,536
Friday,6/2/2017,2959,2171,1680,491
Saturday,6/3/2017,2006,1471,1161,310
Sunday,6/4/2017,2479,1795,1419,376
Monday,6/5/2017,3501,2610,2072,538
Tuesday,6/6/2017,3985,2922,2361,561
Wednesday,6/7/2017,3920,2913,2314,599
Thursday,6/8/2017,3868,2796,2209,587
Friday,6/9/2017,2921,2101,1660,441
Saturday,6/10/2017,1655,1244,975,269
Sunday,6/11/2017,2229,1622,1299,323
Monday,6/12/2017,3660,2598,2020,578
Tuesday,6/13/2017,3898,2809,2202,607
Wednesday,6/14/2017,3912,2797,2200,597
Thursday,6/15/2017,3604,2624,2029,595
Friday,6/16/2017,2970,2105,1621,484
Saturday,6/17/2017,1546,1187,957,230
Sunday,6/18/2017,1944,1465,1146,319
Monday,6/19/2017,3608,2493,1959,534
Tuesday,6/20/2017,3514,2472,1905,567
Wednesday,6/21/2017,3344,2475,1915,560
Thursday,6/22/2017,3292,2351,1824,527
Friday,6/23/2017,2469,1850,1445,405
Saturday,6/24/2017,1296,925,702,223
Sunday,6/25/2017,1546,1071,811,260
Monday,6/26/2017,2948,1998,1528,470
Tuesday,6/27/2017,3077,2190,1690,500
Wednesday,6/28/2017,3028,2145,1649,496
Thursday,6/29/2017,2738,1976,1474,502
Friday,6/30/2017,2147,1478,1087,391
Saturday,7/1/2017,1277,903,675,228
Sunday,7/2/2017,1606,1142,879,263
Monday,7/3/2017,2504,1726,1296,430
Tuesday,7/4/2017,2218,1566,1217,349
Wednesday,7/5/2017,3024,2149,1681,468
Thursday,7/6/2017,2951,2047,1555,492
Friday,7/7/2017,2401,1693,1310,383
Saturday,7/8/2017,1242,891,700,191
Sunday,7/9/2017,1511,1172,938,234
Monday,7/10/2017,2934,2062,1619,443
Tuesday,7/11/2017,3003,2140,1663,477
Wednesday,7/12/2017,3073,2192,1710,482
Thursday,7/13/2017,2933,2043,1550,493
Friday,7/14/2017,2468,1710,1287,423
Saturday,7/15/2017,1355,892,689,203
Sunday,7/16/2017,1553,1122,891,231
Monday,7/17/2017,2902,1954,1479,475
Tuesday,7/18/2017,2899,2109,1591,518
Wednesday,7/19/2017,2986,2032,1584,448
Thursday,7/20/2017,2964,2031,1571,460
Friday,7/21/2017,2433,1609,1214,395
Saturday,7/22/2017,1280,923,725,198
Sunday,7/23/2017,1603,1170,909,261
Monday,7/24/2017,3154,2214,1726,488
Tuesday,7/25/2017,3084,2148,1666,482
Wednesday,7/26/2017,2983,1925,1490,435
Thursday,7/27/2017,2849,1908,1440,468
Friday,7/28/2017,2420,1538,1150,388
Saturday,7/29/2017,1300,895,712,183
Sunday,7/30/2017,1526,1112,863,249
Monday,7/31/2017,2872,1978,1481,497
Tuesday,8/1/2017,2914,1957,1463,494
Wednesday,8/2/2017,2843,1994,1536,458
Thursday,8/3/2017,2649,1894,1447,447
Friday,8/4/2017,2042,1478,1150,328
Saturday,8/5/2017,1225,901,681,220
Sunday,8/6/2017,1562,1045,792,253
Monday,8/7/2017,2751,1823,1398,425
Tuesday,8/8/2017,2634,1868,1415,453
Wednesday,8/9/2017,2704,1961,1511,450
Thursday,8/10/2017,2670,1864,1463,401
Friday,8/11/2017,2073,1498,1121,377
Saturday,8/12/2017,1240,888,669,219
Sunday,8/13/2017,1530,1076,811,265
Monday,8/14/2017,2392,1704,1346,358
Tuesday,8/15/2017,2675,1846,1471,375
Wednesday,8/16/2017,2755,1911,1436,475
Thursday,8/17/2017,2608,1824,1421,403
Friday,8/18/2017,2163,1521,1163,358
Saturday,8/19/2017,1304,951,743,208
Sunday,8/20/2017,1969,1419,1156,263
Monday,8/21/2017,2985,2069,1575,494
Tuesday,8/22/2017,3087,2259,1772,487
Wednesday,8/23/2017,3047,2147,1704,443
Thursday,8/24/2017,2961,2026,1600,426
Friday,8/25/2017,2293,1589,1257,332
Saturday,8/26/2017,1261,934,751,183
Sunday,8/27/2017,1676,1211,983,228
Monday,8/28/2017,1786,1287,1005,282
Tuesday,8/29/2017,3252,2310,1845,465
Wednesday,8/30/2017,3082,2179,1741,438
Thursday,8/31/2017,2721,1963,1579,384
Friday,9/1/2017,2217,1583,1235,348
Saturday,9/2/2017,1271,908,730,178
Sunday,9/3/2017,1742,1197,958,239
Monday,9/4/2017,2293,1704,1380,324
Tuesday,9/5/2017,3155,2289,1818,471
Wednesday,9/6/2017,3159,2320,1882,438
Thursday,9/7/2017,3054,2243,1777,466
Friday,9/8/2017,2440,1848,1488,360
Saturday,9/9/2017,1532,1108,924,184
Sunday,9/10/2017,2247,1657,1366,291
Monday,9/11/2017,3570,2496,2033,463
Tuesday,9/12/2017,3524,2540,2075,465
Wednesday,9/13/2017,3471,2473,2040,433
Thursday,9/14/2017,3303,2415,1974,441
Friday,9/15/2017,2560,1867,1519,348
Saturday,9/16/2017,1470,1090,912,178
Sunday,9/17/2017,2234,1715,1446,269
Monday,9/18/2017,3504,2596,2123,473
Tuesday,9/19/2017,3984,2840,2382,458
Wednesday,9/20/2017,3746,2660,2188,472
Thursday,9/21/2017,3524,2667,2143,524
Friday,9/22/2017,2639,1944,1591,353
Saturday,9/23/2017,1523,1178,975,203
Sunday,9/24/2017,2425,1809,1521,288
Monday,9/25/2017,3671,2705,2202,503
Tuesday,9/26/2017,3669,2780,2306,474
Wednesday,9/27/2017,3537,2657,2211,446
Thursday,9/28/2017,3413,2507,2048,459
Friday,9/29/2017,2699,1902,1554,348
Saturday,9/30/2017,1829,1289,1058,231
Sunday,10/1/2017,2379,1812,1507,305
Monday,10/2/2017,3637,2669,2221,448
Tuesday,10/3/2017,3775,2787,2253,534
Wednesday,10/4/2017,3572,2731,2245,486
Thursday,10/5/2017,3605,2695,2230,465
Friday,10/6/2017,2774,2078,1670,408
Saturday,10/7/2017,1780,1354,1106,248
Sunday,10/8/2017,2469,1884,1571,313
Monday,10/9/2017,3881,2869,2348,521
Tuesday,10/10/2017,3767,2785,2296,489
Wednesday,10/11/2017,4082,2924,2335,589
Thursday,10/12/2017,4047,2768,2240,528
Friday,10/13/2017,2877,2114,1706,408
Saturday,10/14/2017,2073,1559,1298,261
Sunday,10/15/2017,2759,2066,1739,327
Monday,10/16/2017,3817,2880,2344,536
Tuesday,10/17/2017,3949,2930,2402,528
Wednesday,10/18/2017,3867,2896,2395,501
Thursday,10/19/2017,3621,2582,2119,463
Friday,10/20/2017,2978,2220,1772,448
Saturday,10/21/2017,1992,1434,1158,276
Sunday,10/22/2017,2851,2142,1779,363
Monday,10/23/2017,4390,3177,2651,526
Tuesday,10/24/2017,3886,2938,2406,532
Wednesday,10/25/2017,3424,2477,2017,460
Thursday,10/26/2017,4207,3087,2561,526
Friday,10/27/2017,3345,2478,1984,494
Saturday,10/28/2017,2128,1567,1277,290
Sunday,10/29/2017,2205,1637,1319,318
Monday,10/30/2017,4091,2999,2453,546
Tuesday,10/31/2017,4223,3143,2555,588
Wednesday,11/1/2017,4361,3147,2554,593
Thursday,11/2/2017,4263,3103,2513,590
Friday,11/3/2017,3341,2397,1903,494
Saturday,11/4/2017,2278,1634,1307,327
Sunday,11/5/2017,3097,2299,1888,411
Monday,11/6/2017,4185,3113,2538,575
Tuesday,11/7/2017,4477,3341,2689,652
Wednesday,11/8/2017,4354,3227,2579,648
Thursday,11/9/2017,4194,3005,2401,604
Friday,11/10/2017,3240,2319,1833,486
Saturday,11/11/2017,2424,1613,1283,330
Sunday,11/12/2017,3168,2309,1853,456
Monday,11/13/2017,4709,3433,2784,649
Tuesday,11/14/2017,4634,3373,2727,646
Wednesday,11/15/2017,4545,3345,2681,664
Thursday,11/16/2017,4532,3332,2693,639
Friday,11/17/2017,3317,2508,2018,490
Saturday,11/18/2017,2449,1741,1386,355
Sunday,11/19/2017,2893,2231,1780,451
Monday,11/20/2017,4170,3135,2555,580
Tuesday,11/21/2017,4277,3026,2419,607
Wednesday,11/22/2017,3588,2625,2078,547
Thursday,11/23/2017,3141,2237,1760,477
Friday,11/24/2017,2658,1843,1429,414
Saturday,11/25/2017,2391,1652,1327,325
Sunday,11/26/2017,3202,2354,1901,453
Monday,11/27/2017,4349,3251,2601,650
Tuesday,11/28/2017,4886,3660,2968,692
Wednesday,11/29/2017,4555,3484,2824,660
Thursday,11/30/2017,4477,3134,2530,604
Friday,12/1/2017,3577,2603,2056,547
Saturday,12/2/2017,2430,1827,1461,366
Sunday,12/3/2017,3449,2504,2006,498
Monday,12/4/2017,4955,3673,3019,654
Tuesday,12/5/2017,4475,3435,2775,660
Wednesday,12/6/2017,4595,3452,2766,686
Thursday,12/7/2017,4451,3199,2563,636
Friday,12/8/2017,3418,2549,2037,512
Saturday,12/9/2017,2605,1944,1572,372
Sunday,12/10/2017,3483,2607,2102,505
Monday,12/11/2017,4651,3350,2656,694
Tuesday,12/12/2017,4029,3011,2351,660
Wednesday,12/13/2017,4282,3205,2609,596
Thursday,12/14/2017,4138,2930,2315,615
Friday,12/15/2017,4130,2803,2211,592
Saturday,12/16/2017,2581,1761,1429,332
Sunday,12/17/2017,3355,2300,1876,424
Monday,12/18/2017,4482,3109,2491,618
Tuesday,12/19/2017,4584,3021,2456,565
Wednesday,12/20/2017,4106,2661,2133,528
Thursday,12/21/2017,3378,2243,1798,445
Friday,12/22/2017,2446,1544,1211,333
Saturday,12/23/2017,1447,958,753,205
Sunday,12/24/2017,1326,895,696,199
Monday,12/25/2017,1609,1015,809,206
Tuesday,12/26/2017,2481,1438,1105,333
Wednesday,12/27/2017,2798,1740,1350,390
Thursday,12/28/2017,2809,1797,1425,372
Friday,12/29/2017,2216,1410,1083,327
Saturday,12/30/2017,1546,1071,839,232
Sunday,12/31/2017,1339,923,724,199
Monday,1/1/2018,1709,1120,878,242
Tuesday,1/2/2018,3389,2208,1755,453
Wednesday,1/3/2018,3391,2282,1827,455
Thursday,1/4/2018,3698,2310,1878,432
Friday,1/5/2018,3511,2272,1801,471
Saturday,1/6/2018,2279,1498,1196,302
Sunday,1/7/2018,2822,1869,1495,374
Monday,1/8/2018,4240,2784,2186,598
Tuesday,1/9/2018,4319,2844,2302,542
Wednesday,1/10/2018,4224,2866,2304,562
Thursday,1/11/2018,3797,2704,2203,501
Friday,1/12/2018,3190,2127,1692,435
Saturday,1/13/2018,1998,1373,1128,245
Sunday,1/14/2018,2515,1711,1393,318
Monday,1/15/2018,3950,2612,2065,547
Tuesday,1/16/2018,4033,2631,2133,498
Wednesday,1/17/2018,4269,2812,2285,527
Thursday,1/18/2018,4124,2677,2157,520
Friday,1/19/2018,3228,2198,1763,435
Saturday,1/20/2018,2287,1423,1160,263
Sunday,1/21/2018,2946,1996,1628,368
Monday,1/22/2018,4608,3035,2534,501
Tuesday,1/23/2018,4786,3154,2566,588
Wednesday,1/24/2018,4724,3244,2680,564
Thursday,1/25/2018,4417,2875,2348,527
Friday,1/26/2018,3580,2314,1825,489
Saturday,1/27/2018,2345,1544,1229,315
Sunday,1/28/2018,3170,2140,1776,364
Monday,1/29/2018,4862,3194,2573,621
Tuesday,1/30/2018,4600,3106,2504,602
Wednesday,1/31/2018,4705,3249,2704,545
Thursday,2/1/2018,4723,3164,2571,593
Friday,2/2/2018,3969,2572,2104,468
Saturday,2/3/2018,2994,2034,1702,332
Sunday,2/4/2018,3162,2186,1811,375
Monday,2/5/2018,4949,3287,2735,552
Tuesday,2/6/2018,5092,3465,2838,627
Wednesday,2/7/2018,4767,3319,2729,590
Thursday,2/8/2018,4625,3179,2603,576
Friday,2/9/2018,3738,2477,2015,462
Saturday,2/10/2018,2739,1793,1477,316
Sunday,2/11/2018,3923,2476,2077,399
Monday,2/12/2018,5341,3687,3045,642
Tuesday,2/13/2018,5114,3460,2836,624
Wednesday,2/14/2018,4896,3214,2568,646
Thursday,2/15/2018,4502,3050,2507,543
Friday,2/16/2018,3729,2518,2012,506
Saturday,2/17/2018,2388,1618,1319,299
Sunday,2/18/2018,3405,2314,1928,386
Monday,2/19/2018,5176,3620,2971,649
Tuesday,2/20/2018,5429,3597,2978,619
Wednesday,2/21/2018,5120,3448,2869,579
Thursday,2/22/2018,4993,3379,2774,605
Friday,2/23/2018,4148,2751,2221,530
Saturday,2/24/2018,2763,1981,1648,333
Sunday,2/25/2018,3599,2446,2011,435
Monday,2/26/2018,5542,3728,3052,676
Tuesday,2/27/2018,5378,3764,3123,641
Wednesday,2/28/2018,5536,3734,3095,639
Thursday,3/1/2018,4984,3315,2713,602
Friday,3/2/2018,4130,2754,2231,523
Saturday,3/3/2018,2818,1922,1579,343
Sunday,3/4/2018,3978,2699,2249,450
Monday,3/5/2018,5502,3727,3019,708
Tuesday,3/6/2018,5740,3842,3160,682
Wednesday,3/7/2018,5635,3734,3037,697
Thursday,3/8/2018,5375,3704,3044,660
Friday,3/9/2018,4273,3038,2490,548
Saturday,3/10/2018,3223,2305,1918,387
Sunday,3/11/2018,3956,2727,2288,439
Monday,3/12/2018,5895,4141,3447,694
Tuesday,3/13/2018,6152,4207,3398,809
Wednesday,3/14/2018,5906,4021,3305,716
Thursday,3/15/2018,6300,4061,3279,782
Friday,3/16/2018,4915,3259,2673,586
Saturday,3/17/2018,3218,2161,1818,343
Sunday,3/18/2018,4429,2919,2435,484
Monday,3/19/2018,5739,4038,3316,722
Tuesday,3/20/2018,6220,4292,3553,739
Wednesday,3/21/2018,6238,4163,3396,767
Thursday,3/22/2018,6226,4251,3595,656
Friday,3/23/2018,4364,2994,2457,537
Saturday,3/24/2018,2882,2021,1682,339
Sunday,3/25/2018,4010,2748,2263,485
Monday,3/26/2018,6084,3995,3289,706
Tuesday,3/27/2018,5874,4147,3446,701
Wednesday,3/28/2018,5719,3917,3288,629
Thursday,3/29/2018,5003,3396,2812,584
Friday,3/30/2018,3605,2541,2062,479
Saturday,3/31/2018,2811,1901,1512,389
Sunday,4/1/2018,3567,2438,1956,482
Monday,4/2/2018,5237,3542,2875,667
Tuesday,4/3/2018,6154,4126,3438,688
Wednesday,4/4/2018,5895,4112,3418,694
Thursday,4/5/2018,5858,3943,3232,711
Friday,4/6/2018,5034,3348,2749,599
Saturday,4/7/2018,3613,2291,1840,451
Sunday,4/8/2018,4389,3059,2530,529
Monday,4/9/2018,6278,4290,3546,744
Tuesday,4/10/2018,6836,4514,3747,767
Wednesday,4/11/2018,6731,4596,3759,837
Thursday,4/12/2018,6287,4332,3563,769
Friday,4/13/2018,5089,3454,2850,604
Saturday,4/14/2018,3812,2542,2094,448
Sunday,4/15/2018,5290,3538,2914,624
Monday,4/16/2018,7161,4993,4188,805
Tuesday,4/17/2018,7352,4939,4058,881
Wednesday,4/18/2018,7218,4842,4001,841
Thursday,4/19/2018,7040,4672,3895,777
Friday,4/20/2018,5367,3728,3029,699
Saturday,4/21/2018,4021,2749,2253,496
Sunday,4/22/2018,5397,3722,3059,663
Monday,4/23/2018,7605,5124,4216,908
Tuesday,4/24/2018,7614,5094,4181,913
Wednesday,4/25/2018,7984,5541,4616,925
Thursday,4/26/2018,7040,4823,3957,866
Friday,4/27/2018,5628,3749,3095,654
Saturday,4/28/2018,3926,2618,2141,477
Sunday,4/29/2018,5479,3635,3057,578
Monday,4/30/2018,6670,4584,3784,800
Tuesday,5/1/2018,6783,4542,3742,800
Wednesday,5/2/2018,7105,4865,4013,852
Thursday,5/3/2018,6877,4702,3854,848
Friday,5/4/2018,5460,3711,3039,672
Saturday,5/5/2018,3648,2568,2058,510
Sunday,5/6/2018,4917,3311,2737,574
Monday,5/7/2018,6980,4654,3881,773
Tuesday,5/8/2018,6702,4577,3700,877
Wednesday,5/9/2018,6699,4488,3581,907
Thursday,5/10/2018,6001,4059,3265,794
Friday,5/11/2018,5094,3454,2766,688
Saturday,5/12/2018,3179,2237,1821,416
Sunday,5/13/2018,4169,2912,2413,499
Monday,5/14/2018,6392,4388,3637,751
Tuesday,5/15/2018,5878,4094,3384,710
Wednesday,5/16/2018,5800,3976,3266,710
Thursday,5/17/2018,5690,4023,3254,769
Friday,5/18/2018,4314,2986,2400,586
Saturday,5/19/2018,2948,2117,1735,382
Sunday,5/20/2018,3864,2674,2155,519
Monday,5/21/2018,5499,3708,3005,703
Tuesday,5/22/2018,5790,4040,3269,771
Wednesday,5/23/2018,5720,3971,3206,765
Thursday,5/24/2018,5692,3675,2965,710
Friday,5/25/2018,4082,2803,2188,615
Saturday,5/26/2018,2716,1965,1597,368
Sunday,5/27/2018,3430,2374,1887,487
Monday,5/28/2018,4353,2994,2392,602
Tuesday,5/29/2018,5525,3777,3112,665
Wednesday,5/30/2018,5407,3574,2908,666
Thursday,5/31/2018,4994,3485,2792,693
Friday,6/1/2018,3835,2681,2172,509
Saturday,6/2/2018,2511,1750,1423,327
Sunday,6/3/2018,3371,2308,1891,417
Monday,6/4/2018,5226,3399,2741,658
Tuesday,6/5/2018,5139,3453,2811,642
Wednesday,6/6/2018,5051,3474,2828,646
Thursday,6/7/2018,4787,3283,2685,598
Friday,6/8/2018,3956,2670,2107,563
Saturday,6/9/2018,2303,1589,1278,311
Sunday,6/10/2018,3011,2091,1717,374
Monday,6/11/2018,4896,3326,2714,612
Tuesday,6/12/2018,4952,3309,2624,685
Wednesday,6/13/2018,4570,3099,2439,660
Thursday,6/14/2018,4542,2962,2377,585
Friday,6/15/2018,3383,2320,1847,473
Saturday,6/16/2018,1922,1316,1061,255
Sunday,6/17/2018,2404,1677,1361,316
Monday,6/18/2018,4576,2964,2313,651
Tuesday,6/19/2018,4727,3144,2519,625
Wednesday,6/20/2018,4639,2989,2370,619
Thursday,6/21/2018,4108,2762,2154,608
Friday,6/22/2018,3372,2207,1744,463
Saturday,6/23/2018,1996,1277,989,288
Sunday,6/24/2018,2415,1619,1266,353
Monday,6/25/2018,4457,2881,2272,609
Tuesday,6/26/2018,4736,3039,2410,629
Wednesday,6/27/2018,4245,2818,2244,574
Thursday,6/28/2018,4081,2785,2160,625
Friday,6/29/2018,3053,2008,1568,440
Saturday,6/30/2018,1741,1147,927,220
Sunday,7/1/2018,2186,1447,1140,307
Monday,7/2/2018,4026,2533,1952,581
Tuesday,7/3/2018,3961,2515,1966,549
Wednesday,7/4/2018,3019,2032,1595,437
Thursday,7/5/2018,3743,2496,1997,499
Friday,7/6/2018,3050,1995,1575,420
Saturday,7/7/2018,1688,1080,857,223
Sunday,7/8/2018,2185,1440,1145,295
Monday,7/9/2018,4104,2576,2016,560
Tuesday,7/10/2018,4097,2694,2059,635
Wednesday,7/11/2018,3844,2506,1895,611
Thursday,7/12/2018,3743,2530,2001,529
Friday,7/13/2018,3073,2068,1581,487
Saturday,7/14/2018,1852,1249,992,257
Sunday,7/15/2018,2105,1474,1173,301
Monday,7/16/2018,4078,2657,2095,562
Tuesday,7/17/2018,4515,2856,2255,601
Wednesday,7/18/2018,4276,2779,2173,606
Thursday,7/19/2018,4043,2705,2114,591
Friday,7/20/2018,3004,2028,1576,452
Saturday,7/21/2018,1664,1177,942,235
Sunday,7/22/2018,2248,1561,1246,315
Monday,7/23/2018,4062,2658,2081,577
Tuesday,7/24/2018,4053,2680,2091,589
Wednesday,7/25/2018,3628,2431,1879,552
Thursday,7/26/2018,3596,2415,1925,490
Friday,7/27/2018,3140,2002,1539,463
Saturday,7/28/2018,1938,1304,1054,250
Sunday,7/29/2018,2460,1699,1364,335
Monday,7/30/2018,4175,2771,2166,605
Tuesday,7/31/2018,4113,2881,2310,571
Wednesday,8/1/2018,4273,2901,2310,591
Thursday,8/2/2018,4194,2754,2202,552
Friday,8/3/2018,3405,2345,1833,512
Saturday,8/4/2018,1800,1251,1025,226
Sunday,8/5/2018,2378,1694,1388,306
Monday,8/6/2018,4319,2856,2233,623
Tuesday,8/7/2018,4388,2971,2375,596
Wednesday,8/8/2018,4205,2724,2118,606
Thursday,8/9/2018,3973,2555,1998,557
Friday,8/10/2018,3510,2224,1777,447
Saturday,8/11/2018,1913,1281,1012,269
Sunday,8/12/2018,2397,1644,1284,360
Monday,8/13/2018,4348,2789,2224,565
Tuesday,8/14/2018,3966,2688,2127,561
Wednesday,8/15/2018,3805,2544,2035,509
Thursday,8/16/2018,3866,2604,2074,530
Friday,8/17/2018,3489,2219,1737,482
Saturday,8/18/2018,2074,1394,1108,286
Sunday,8/19/2018,2519,1687,1318,369
Monday,8/20/2018,4202,2734,2128,606
Tuesday,8/21/2018,4023,2711,2147,564
Wednesday,8/22/2018,4048,2685,2121,564
Thursday,8/23/2018,4150,2860,2249,611
Friday,8/24/2018,3154,2199,1742,457
Saturday,8/25/2018,2143,1317,1012,305
Sunday,8/26/2018,2576,1705,1372,333
Monday,8/27/2018,4317,2954,2367,587
Tuesday,8/28/2018,4421,3023,2427,596
Wednesday,8/29/2018,4563,3019,2395,624
Thursday,8/30/2018,4055,2798,2265,533
Friday,8/31/2018,3427,2305,1815,490
Saturday,9/1/2018,1731,1241,989,252
Sunday,9/2/2018,2258,1641,1293,348
Monday,9/3/2018,3655,2499,2032,467
Tuesday,9/4/2018,4456,2995,2435,560
Wednesday,9/5/2018,4566,3042,2456,586
Thursday,9/6/2018,4314,3049,2508,541
Friday,9/7/2018,3557,2349,1890,459
Saturday,9/8/2018,2281,1548,1255,293
Sunday,9/9/2018,3346,2255,1906,349
Monday,9/10/2018,4711,3200,2600,600
Tuesday,9/11/2018,4709,3134,2595,539
Wednesday,9/12/2018,4379,3032,2464,568
Thursday,9/13/2018,4357,2870,2325,545
Friday,9/14/2018,3560,2396,1907,489
Saturday,9/15/2018,2049,1488,1244,244
Sunday,9/16/2018,2813,1934,1614,320
Monday,9/17/2018,5064,3241,2621,620
Tuesday,9/18/2018,5006,3221,2595,626
Wednesday,9/19/2018,4949,3282,2708,574
Thursday,9/20/2018,4695,3165,2573,592
Friday,9/21/2018,3516,2383,1933,450
Saturday,9/22/2018,2460,1704,1374,330
Sunday,9/23/2018,2994,2127,1733,394
Monday,9/24/2018,4688,3273,2679,594
Tuesday,9/25/2018,4924,3481,2885,596
Wednesday,9/26/2018,5209,3546,2936,610
Thursday,9/27/2018,5966,4029,3385,644
Friday,9/28/2018,4740,3171,2643,528
Saturday,9/29/2018,2715,1870,1618,252
Sunday,9/30/2018,3739,2573,2194,379
Monday,10/1/2018,5841,3982,3331,651
Tuesday,10/2/2018,5881,4096,3514,582
Wednesday,10/3/2018,5540,3863,3249,614
Thursday,10/4/2018,5636,3894,3306,588
Friday,10/5/2018,4479,3120,2638,482
Saturday,10/6/2018,3076,2094,1750,344
Sunday,10/7/2018,3973,2865,2457,408
Monday,10/8/2018,6045,4310,3659,651
Tuesday,10/9/2018,6126,4173,3522,651
Wednesday,10/10/2018,6084,4319,3616,703
Thursday,10/11/2018,6154,4254,3632,622
Friday,10/12/2018,4868,3385,2784,601
Saturday,10/13/2018,3409,2379,2006,373
Sunday,10/14/2018,4722,3357,2859,498
Monday,10/15/2018,6555,4550,3766,784
Tuesday,10/16/2018,7079,4652,3893,759
Wednesday,10/17/2018,6691,4673,3893,780
Thursday,10/18/2018,6522,4398,3666,732
Friday,10/19/2018,4922,3390,2857,533
Saturday,10/20/2018,3409,2399,1990,409
Sunday,10/21/2018,4483,3092,2623,469
Monday,10/22/2018,6666,4499,3769,730
Tuesday,10/23/2018,6991,4677,3916,761
Wednesday,10/24/2018,6871,4619,3808,811
Thursday,10/25/2018,6357,4331,3579,752
Friday,10/26/2018,5114,3468,2827,641
Saturday,10/27/2018,3456,2400,2006,394
Sunday,10/28/2018,4924,3251,2735,516
Monday,10/29/2018,6837,4704,3890,814
Tuesday,10/30/2018,6481,4547,3798,749
Wednesday,10/31/2018,6296,4316,3545,771
Thursday,11/1/2018,6044,3988,3299,689
Friday,11/2/2018,4860,3326,2738,588
Saturday,11/3/2018,3430,2289,1946,343
Sunday,11/4/2018,4638,3236,2744,492
Monday,11/5/2018,6365,4329,3609,720
Tuesday,11/6/2018,6330,4291,3556,735
Wednesday,11/7/2018,5865,3937,3267,670
Thursday,11/8/2018,5692,3938,3298,640
Friday,11/9/2018,5026,3533,2917,616
Saturday,11/10/2018,3506,2428,2018,410
Sunday,11/11/2018,4778,3265,2709,556
Monday,11/12/2018,6684,4592,3795,797
Tuesday,11/13/2018,6766,4720,3918,802
Wednesday,11/14/2018,6916,4674,3872,802
Thursday,11/15/2018,6440,4379,3634,745
Friday,11/16/2018,5066,3497,2863,634
Saturday,11/17/2018,3503,2489,2043,446
Sunday,11/18/2018,4855,3321,2691,630
Monday,11/19/2018,6818,4601,3795,806
Tuesday,11/20/2018,6239,4424,3640,784
Wednesday,11/21/2018,5471,3904,3194,710
Thursday,11/22/2018,4453,3186,2592,594
Friday,11/23/2018,4062,2892,2347,545
Saturday,11/24/2018,3485,2445,1987,458
Sunday,11/25/2018,4906,3371,2815,556
Monday,11/26/2018,7099,4871,4012,859
Tuesday,11/27/2018,7503,5181,4267,914
Wednesday,11/28/2018,7554,5227,4330,897
Thursday,11/29/2018,7169,4944,4106,838
Friday,11/30/2018,5608,3895,3211,684
Saturday,12/1/2018,4055,2800,2306,494
Sunday,12/2/2018,5611,3906,3259,647
Monday,12/3/2018,7650,5378,4431,947
Tuesday,12/4/2018,7372,5225,4328,897
Wednesday,12/5/2018,7369,5166,4316,850
Thursday,12/6/2018,7250,5093,4213,880
Friday,12/7/2018,5735,4032,3296,736
Saturday,12/8/2018,4614,3240,2699,541
Sunday,12/9/2018,5979,4062,3352,710
Monday,12/10/2018,7840,5421,4465,956
Tuesday,12/11/2018,7659,5267,4330,937
Wednesday,12/12/2018,7319,4983,4010,973
Thursday,12/13/2018,6373,4452,3620,832
Friday,12/14/2018,4897,3404,2776,628
Saturday,12/15/2018,3325,2209,1833,376
Sunday,12/16/2018,3874,2671,2206,465
Monday,12/17/2018,5436,3791,3062,729
Tuesday,12/18/2018,5174,3562,2945,617
Wednesday,12/19/2018,4873,3255,2632,623
Thursday,12/20/2018,3913,2716,2164,552
Friday,12/21/2018,2934,1979,1543,436
Saturday,12/22/2018,1523,1074,846,228
Sunday,12/23/2018,1859,1223,997,226
Monday,12/24/2018,1835,1310,1019,291
Tuesday,12/25/2018,1852,1214,955,259
Wednesday,12/26/2018,2357,1594,1243,351
Thursday,12/27/2018,2583,1783,1418,365
Friday,12/28/2018,2477,1613,1279,334
Saturday,12/29/2018,1694,1197,990,207
Sunday,12/30/2018,1985,1340,1097,243
Monday,12/31/2018,1723,1159,874,285
Tuesday,1/1/2019,1715,1168,891,277
Wednesday,1/2/2019,3431,2361,1899,462
Thursday,1/3/2019,4118,2793,2259,534
Friday,1/4/2019,3504,2373,1936,437
Saturday,1/5/2019,2308,1609,1348,261
Sunday,1/6/2019,2925,2046,1648,398
Monday,1/7/2019,4587,3100,2550,550
Tuesday,1/8/2019,4731,3182,2585,597
Wednesday,1/9/2019,4831,3245,2660,585
Thursday,1/10/2019,4162,2836,2298,538
Friday,1/11/2019,3726,2476,1999,477
Saturday,1/12/2019,2458,1722,1413,309
Sunday,1/13/2019,3266,2264,1878,386
Monday,1/14/2019,5016,3348,2760,588
Tuesday,1/15/2019,4732,3320,2738,582
Wednesday,1/16/2019,4938,3447,2845,602
Thursday,1/17/2019,5033,3516,2967,549
Friday,1/18/2019,4114,2731,2236,495
Saturday,1/19/2019,2780,1929,1599,330
Sunday,1/20/2019,4205,2367,1974,393
Monday,1/21/2019,4983,3391,2783,608
Tuesday,1/22/2019,5182,3674,3052,622
Wednesday,1/23/2019,5316,3856,3199,657
Thursday,1/24/2019,5021,3462,2853,609
Friday,1/25/2019,4230,2882,2382,500
Saturday,1/26/2019,2743,1882,1541,341
Sunday,1/27/2019,3890,2622,2232,390
Monday,1/28/2019,5575,3925,3232,693
Tuesday,1/29/2019,5732,3866,3260,606
Wednesday,1/30/2019,5402,3759,3134,625
Thursday,1/31/2019,5069,3597,2984,613
Friday,2/1/2019,4222,2923,2364,559
Saturday,2/2/2019,2864,1902,1596,306
Sunday,2/3/2019,3598,2447,2044,403
Monday,2/4/2019,5366,3767,3146,621
Tuesday,2/5/2019,5427,3757,3124,633
Wednesday,2/6/2019,5667,3759,3130,629
Thursday,2/7/2019,5517,3763,3069,694
Friday,2/8/2019,4420,2943,2429,514
Saturday,2/9/2019,3150,2274,1911,363
Sunday,2/10/2019,4264,2962,2470,492
Monday,2/11/2019,6569,4276,3566,710
Tuesday,2/12/2019,6145,4092,3391,701
Wednesday,2/13/2019,5743,3932,3236,696
Thursday,2/14/2019,5512,3762,3075,687
Friday,2/15/2019,4127,2952,2377,575
Saturday,2/16/2019,3309,2195,1809,386
Sunday,2/17/2019,3761,2669,2217,452
Monday,2/18/2019,5592,3912,3226,686
Tuesday,2/19/2019,6100,4322,3575,747
Wednesday,2/20/2019,6208,4265,3543,722
Thursday,2/21/2019,5730,4071,3352,719
Friday,2/22/2019,4372,3073,2508,565
Saturday,2/23/2019,3378,2259,1871,388
Sunday,2/24/2019,4367,3012,2524,488
Monday,2/25/2019,6318,4424,3678,746
Tuesday,2/26/2019,6431,4304,3530,774
Wednesday,2/27/2019,5919,4205,3442,763
Thursday,2/28/2019,5668,3966,3266,700
Friday,3/1/2019,4581,3178,2594,584
Saturday,3/2/2019,3383,2263,1878,385
Sunday,3/3/2019,4311,3005,2476,529
Monday,3/4/2019,6357,4214,3443,771
Tuesday,3/5/2019,6092,4092,3343,749
Wednesday,3/6/2019,5772,4070,3340,730
Thursday,3/7/2019,5861,4064,3330,734
Friday,3/8/2019,4600,3147,2590,557
Saturday,3/9/2019,3390,2218,1849,369
Sunday,3/10/2019,4099,2898,2397,501
Monday,3/11/2019,6240,4320,3599,721
Tuesday,3/12/2019,5871,4127,3375,752
Wednesday,3/13/2019,6381,4506,3726,780
Thursday,3/14/2019,5853,4043,3328,715
Friday,3/15/2019,4425,3116,2499,617
Saturday,3/16/2019,2961,2099,1685,414
Sunday,3/17/2019,4008,2744,2258,486
Monday,3/18/2019,5830,4040,3319,721
Tuesday,3/19/2019,6089,4164,3448,716
Wednesday,3/20/2019,5800,3946,3192,754
Thursday,3/21/2019,5431,3761,3100,661
Friday,3/22/2019,4560,3071,2543,528
Saturday,3/23/2019,3256,2254,1859,395
Sunday,3/24/2019,4156,2858,2386,472
Monday,3/25/2019,6060,4232,3469,763
Tuesday,3/26/2019,6191,4344,3578,766
Wednesday,3/27/2019,6678,4612,3842,770
Thursday,3/28/2019,6167,4086,3361,725
Friday,3/29/2019,4441,3147,2601,546
Saturday,3/30/2019,3243,2325,1949,376
Sunday,3/31/2019,4260,3039,2543,496
Monday,4/1/2019,6078,4238,3550,688
Tuesday,4/2/2019,6824,4656,3833,823
Wednesday,4/3/2019,6621,4727,3942,785
Thursday,4/4/2019,6231,4343,3647,696
Friday,4/5/2019,4776,3346,2719,627
Saturday,4/6/2019,3148,2319,1924,395
Sunday,4/7/2019,4357,3050,2511,539
Monday,4/8/2019,6794,4738,3960,778
Tuesday,4/9/2019,6688,4505,3736,769
Wednesday,4/10/2019,6570,4448,3646,802
Thursday,4/11/2019,6113,4264,3504,760
Friday,4/12/2019,4856,3336,2726,610
Saturday,4/13/2019,3401,2409,2011,398
Sunday,4/14/2019,4551,3197,2600,597
Monday,4/15/2019,6614,4773,3967,806
Tuesday,4/16/2019,7019,4837,4037,800
Wednesday,4/17/2019,6643,4470,3681,789
Thursday,4/18/2019,5398,3825,3133,692
Friday,4/19/2019,4323,2981,2482,499
Saturday,4/20/2019,3546,2442,2020,422
Sunday,4/21/2019,4312,3045,2534,511
Monday,4/22/2019,6363,4520,3729,791
Tuesday,4/23/2019,6797,4968,4147,821
Wednesday,4/24/2019,7144,5002,4136,866
Thursday,4/25/2019,6555,4621,3804,817
Friday,4/26/2019,5400,3780,3089,691
Saturday,4/27/2019,3710,2465,2038,427
Sunday,4/28/2019,4788,3294,2728,566
Monday,4/29/2019,6232,4340,3578,762
Tuesday,4/30/2019,6093,4264,3440,824
Wednesday,5/1/2019,6117,4275,3556,719
Thursday,5/2/2019,6274,4153,3433,720
Friday,5/3/2019,4774,3370,2763,607
Saturday,5/4/2019,3437,2462,1999,463
Sunday,5/5/2019,4330,3009,2457,552
Monday,5/6/2019,5902,4164,3402,762
Tuesday,5/7/2019,6064,4258,3469,789
Wednesday,5/8/2019,5709,4049,3310,739
Thursday,5/9/2019,5596,3944,3275,669
Friday,5/10/2019,4498,3144,2494,650
Saturday,5/11/2019,3258,2119,1702,417
Sunday,5/12/2019,3571,2565,2070,495
Monday,5/13/2019,5677,3908,3136,772
Tuesday,5/14/2019,5534,3669,2977,692
Wednesday,5/15/2019,5391,3667,2989,678
Thursday,5/16/2019,5043,3577,2953,624
Friday,5/17/2019,3993,2795,2254,541
Saturday,5/18/2019,2565,1876,1545,331
Sunday,5/19/2019,3369,2364,1954,410
Monday,5/20/2019,4993,3442,2806,636
Tuesday,5/21/2019,4728,3406,2813,593
Wednesday,5/22/2019,4963,3431,2772,659
Thursday,5/23/2019,4637,3243,2698,545
Friday,5/24/2019,3694,2559,2070,489
Saturday,5/25/2019,2460,1658,1347,311
Sunday,5/26/2019,3006,2064,1693,371
Monday,5/27/2019,3992,2780,2271,509
Tuesday,5/28/2019,4960,3403,2767,636
Wednesday,5/29/2019,4376,3115,2562,553
Thursday,5/30/2019,4143,2896,2353,543
Friday,5/31/2019,3359,2363,1909,454
Saturday,6/1/2019,2218,1474,1221,253
Sunday,6/2/2019,2768,1845,1516,329
Monday,6/3/2019,3967,2831,2295,536
Tuesday,6/4/2019,4501,3008,2426,582
Wednesday,6/5/2019,3973,2727,2233,494
Thursday,6/6/2019,4259,2871,2312,559
Friday,6/7/2019,3181,2313,1869,444
Saturday,6/8/2019,2170,1583,1324,259
Sunday,6/9/2019,2810,1930,1586,344
Monday,6/10/2019,4420,3030,2463,567
Tuesday,6/11/2019,4793,3258,2664,594
Wednesday,6/12/2019,4410,3064,2479,585
Thursday,6/13/2019,4076,2844,2280,564
Friday,6/14/2019,3287,2265,1789,476
Saturday,6/15/2019,2176,1467,1201,266
Sunday,6/16/2019,2516,1747,1419,328
Monday,6/17/2019,4142,2925,2398,527
Tuesday,6/18/2019,4225,3013,2461,552
Wednesday,6/19/2019,4162,2882,2351,531
Thursday,6/20/2019,3716,2615,2137,478
Friday,6/21/2019,3333,2275,1853,422
Saturday,6/22/2019,1918,1360,1118,242
Sunday,6/23/2019,2344,1621,1317,304
Monday,6/24/2019,3691,2591,2149,442
Tuesday,6/25/2019,4035,2770,2247,523
Wednesday,6/26/2019,3939,2675,2186,489
Thursday,6/27/2019,3738,2671,2197,474
Friday,6/28/2019,2846,2021,1657,364
Saturday,6/29/2019,1733,1199,983,216
Sunday,6/30/2019,2184,1494,1240,254
Monday,7/1/2019,3512,2485,2001,484
Tuesday,7/2/2019,3675,2636,2163,473
Wednesday,7/3/2019,3831,2579,2144,435
Thursday,7/4/2019,2801,1971,1648,323
Friday,7/5/2019,2552,1790,1446,344
Saturday,7/6/2019,1950,1291,1110,181
Sunday,7/7/2019,2110,1477,1209,268
Monday,7/8/2019,4303,2903,2383,520
Tuesday,7/9/2019,3883,2799,2335,464
Wednesday,7/10/2019,4244,2907,2347,560
Thursday,7/11/2019,3765,2669,2150,519
Friday,7/12/2019,3286,2276,1816,460
Saturday,7/13/2019,1851,1305,1063,242
Sunday,7/14/2019,2580,1754,1433,321
Monday,7/15/2019,4140,2911,2382,529
Tuesday,7/16/2019,4076,2785,2285,500
Wednesday,7/17/2019,4141,2900,2360,540
Thursday,7/18/2019,3898,2774,2249,525
Friday,7/19/2019,3027,2078,1641,437
Saturday,7/20/2019,1831,1271,1033,238
Sunday,7/21/2019,2282,1617,1356,261
Monday,7/22/2019,4138,2890,2376,514
Tuesday,7/23/2019,4049,2868,2344,524
Wednesday,7/24/2019,4272,2963,2359,604
Thursday,7/25/2019,4089,2755,2210,545
Friday,7/26/2019,3277,2264,1842,422
Saturday,7/27/2019,1954,1308,1069,239
Sunday,7/28/2019,2111,1509,1239,270
Monday,7/29/2019,3625,2539,2053,486
Tuesday,7/30/2019,4415,2906,2386,520
Wednesday,7/31/2019,3854,2743,2260,483
Thursday,8/1/2019,4114,2771,2262,509
Friday,8/2/2019,3492,2280,1874,406
Saturday,8/3/2019,1849,1312,1096,216
Sunday,8/4/2019,2239,1630,1347,283
Monday,8/5/2019,3976,2664,2191,473
Tuesday,8/6/2019,4061,2833,2284,549
Wednesday,8/7/2019,3702,2675,2215,460
Thursday,8/8/2019,3622,2553,2112,441
Friday,8/9/2019,3039,2033,1660,373
Saturday,8/10/2019,1848,1265,1049,216
Sunday,8/11/2019,2082,1502,1242,260
Monday,8/12/2019,3807,2574,2121,453
Tuesday,8/13/2019,3993,2667,2215,452
Wednesday,8/14/2019,3567,2517,2087,430
Thursday,8/15/2019,3484,2450,2046,404
Friday,8/16/2019,2994,2022,1663,359
Saturday,8/17/2019,1793,1276,1074,202
Sunday,8/18/2019,2422,1721,1477,244
Monday,8/19/2019,4070,2847,2371,476
Tuesday,8/20/2019,3987,2800,2293,507
Wednesday,8/21/2019,3355,2407,1963,444
Thursday,8/22/2019,2925,1959,1627,332
Friday,8/23/2019,3010,2143,1769,374
Saturday,8/24/2019,1896,1380,1151,229
Sunday,8/25/2019,2501,1791,1497,294
Monday,8/26/2019,3851,2714,2257,457
Tuesday,8/27/2019,4403,3075,2622,453
Wednesday,8/28/2019,4627,3125,2623,502
Thursday,8/29/2019,4221,2982,2477,505
Friday,8/30/2019,3025,2102,1727,375
Saturday,8/31/2019,1998,1386,1179,207
Sunday,9/1/2019,2297,1645,1414,231
Monday,9/2/2019,3192,2272,1910,362
Tuesday,9/3/2019,4087,2921,2434,487
Wednesday,9/4/2019,4787,3348,2842,506
Thursday,9/5/2019,4483,3078,2570,508
Friday,9/6/2019,3571,2483,2095,388
Saturday,9/7/2019,2263,1566,1343,223
Sunday,9/8/2019,2948,2118,1827,291
Monday,9/9/2019,4521,3287,2785,502
Tuesday,9/10/2019,4563,3251,2758,493
Wednesday,9/11/2019,4598,3365,2901,464
Thursday,9/12/2019,4603,3356,2868,488
Friday,9/13/2019,3349,2508,2121,387
Saturday,9/14/2019,2437,1716,1451,265
Sunday,9/15/2019,3188,2367,2082,285
Monday,9/16/2019,5291,3839,3280,559
Tuesday,9/17/2019,5477,3815,3273,542
Wednesday,9/18/2019,5257,3726,3222,504
Thursday,9/19/2019,5000,3500,3028,472
Friday,9/20/2019,3890,2822,2407,415
Saturday,9/21/2019,2654,1994,1739,255
Sunday,9/22/2019,3656,2640,2328,312
Monday,9/23/2019,5223,3804,3291,513
Tuesday,9/24/2019,5276,3826,3287,539
Wednesday,9/25/2019,5476,3838,3306,532
Thursday,9/26/2019,5196,3718,3208,510
Friday,9/27/2019,4052,2863,2448,415
Saturday,9/28/2019,2635,1945,1696,249
Sunday,9/29/2019,4076,2895,2541,354
Monday,9/30/2019,5167,3754,3216,538
Tuesday,10/1/2019,4972,3634,3082,552
Wednesday,10/2/2019,5143,3683,3209,474
Thursday,10/3/2019,4753,3454,2941,513
Friday,10/4/2019,3795,2854,2440,414
Saturday,10/5/2019,2920,2118,1827,291
Sunday,10/6/2019,3950,2850,2471,379
Monday,10/7/2019,5493,3929,3432,497
Tuesday,10/8/2019,5652,4186,3705,481
Wednesday,10/9/2019,5617,3936,3388,548
Thursday,10/10/2019,5234,3802,3261,541
Friday,10/11/2019,4118,3147,2674,473
Saturday,10/12/2019,2863,2111,1803,308
Sunday,10/13/2019,4032,3013,2645,368
Monday,10/14/2019,5476,4022,3466,556
Tuesday,10/15/2019,5542,4117,3572,545
Wednesday,10/16/2019,5340,3966,3403,563
Thursday,10/17/2019,5388,3905,3333,572
Friday,10/18/2019,4309,3097,2675,422
Saturday,10/19/2019,3117,2223,1897,326
Sunday,10/20/2019,4234,3081,2679,402
Monday,10/21/2019,5698,4144,3507,637
Tuesday,10/22/2019,5721,4132,3536,596
Wednesday,10/23/2019,6018,4446,3823,623
Thursday,10/24/2019,5563,3995,3397,598
Friday,10/25/2019,4159,2961,2461,500
Saturday,10/26/2019,2732,2057,1753,304
Sunday,10/27/2019,3901,2854,2460,394
Monday,10/28/2019,5749,4120,3529,591
Tuesday,10/29/2019,5821,4140,3576,564
Wednesday,10/30/2019,5647,4059,3452,607
Thursday,10/31/2019,5219,3689,3180,509
Friday,11/1/2019,4054,3010,2604,406
Saturday,11/2/2019,2815,2170,1889,281
Sunday,11/3/2019,4253,3063,2603,460
Monday,11/4/2019,5816,4184,3640,544
Tuesday,11/5/2019,5843,4176,3549,627
Wednesday,11/6/2019,6058,4351,3672,679
Thursday,11/7/2019,6291,4489,3810,679
Friday,11/8/2019,4604,3357,2839,518
Saturday,11/9/2019,3354,2337,2000,337
Sunday,11/10/2019,4190,3075,2634,441
Monday,11/11/2019,5931,4194,3573,621
Tuesday,11/12/2019,6443,4589,3877,712
Wednesday,11/13/2019,5805,4275,3572,703
Thursday,11/14/2019,5753,4172,3569,603
Friday,11/15/2019,4709,3452,2927,525
Saturday,11/16/2019,3418,2506,2136,370
Sunday,11/17/2019,4821,3387,2872,515
Monday,11/18/2019,6444,4699,3985,714
Tuesday,11/19/2019,6607,4772,4119,653
Wednesday,11/20/2019,6726,4781,4115,666
Thursday,11/21/2019,6334,4462,3840,622
Friday,11/22/2019,4575,3214,2724,490
Saturday,11/23/2019,3414,2474,2118,356
Sunday,11/24/2019,4535,3242,2787,455
Monday,11/25/2019,5970,4467,3836,631
Tuesday,11/26/2019,5630,4115,3522,593
Wednesday,11/27/2019,5384,3823,3225,598
Thursday,11/28/2019,4201,3223,2747,476
Friday,11/29/2019,3799,2947,2504,443
Saturday,11/30/2019,3301,2443,2053,390
Sunday,12/1/2019,4420,3308,2849,459
Monday,12/2/2019,6384,4674,4031,643
Tuesday,12/3/2019,6964,4975,4285,690
Wednesday,12/4/2019,6957,4959,4252,707
Thursday,12/5/2019,6350,4671,3989,682
Friday,12/6/2019,5324,3796,3258,538
Saturday,12/7/2019,3795,2760,2362,398
Sunday,12/8/2019,5013,3636,3159,477
Monday,12/9/2019,7005,5250,4569,681
Tuesday,12/10/2019,6606,4791,4131,660
Wednesday,12/11/2019,6686,4902,4240,662
Thursday,12/12/2019,6163,4533,3871,662
Friday,12/13/2019,4581,3272,2801,471
Saturday,12/14/2019,2930,2240,1958,282
Sunday,12/15/2019,3585,2672,2280,392
Monday,12/16/2019,4925,3653,3128,525
Tuesday,12/17/2019,4743,3441,2895,546
Wednesday,12/18/2019,4716,3390,2918,472
Thursday,12/19/2019,3793,2821,2381,440
Friday,12/20/2019,2688,1906,1583,323
Saturday,12/21/2019,1682,1177,1020,157
Sunday,12/22/2019,1880,1411,1190,221
Monday,12/23/2019,2451,1738,1442,296
Tuesday,12/24/2019,1644,1197,977,220
Wednesday,12/25/2019,1483,1027,851,176
Thursday,12/26/2019,1864,1355,1102,253
Friday,12/27/2019,1927,1319,1109,210
Saturday,12/28/2019,1679,1219,1019,200
Sunday,12/29/2019,1962,1299,1111,188
Monday,12/30/2019,2469,1762,1479,283
Tuesday,12/31/2019,1750,1192,1005,187
Wednesday,1/1/2020,1554,1105,870,235
Thursday,1/2/2020,2820,2083,1754,329
Friday,1/3/2020,2970,2180,1859,321
Saturday,1/4/2020,2111,1526,1300,226
Sunday,1/5/2020,2393,1788,1514,274
Monday,1/6/2020,3704,2770,2341,429
Tuesday,1/7/2020,3760,2915,2492,423
Wednesday,1/8/2020,3698,2844,2402,442
Thursday,1/9/2020,4243,3374,2910,464
Friday,1/10/2020,3177,2415,2043,372
Saturday,1/11/2020,2361,1834,1581,253
Sunday,1/12/2020,2762,2238,1961,277
Monday,1/13/2020,4298,3242,2727,515
Tuesday,1/14/2020,3838,2884,2450,434
Wednesday,1/15/2020,3754,2864,2470,394
Thursday,1/16/2020,3817,2951,2510,441
Friday,1/17/2020,3175,2419,2006,413
Saturday,1/18/2020,2336,1927,1681,246
Sunday,1/19/2020,2597,2031,1717,314
Monday,1/20/2020,3715,2948,2505,443
Tuesday,1/21/2020,4459,3501,3017,484
Wednesday,1/22/2020,4483,3552,3079,473
Thursday,1/23/2020,4225,3295,2805,490
Friday,1/24/2020,3111,2484,2131,353
Saturday,1/25/2020,2353,1784,1535,249
Sunday,1/26/2020,3198,2520,2213,307
Monday,1/27/2020,4432,3539,3058,481
Tuesday,1/28/2020,4664,3654,3148,506
Wednesday,1/29/2020,4471,3544,3025,519
Thursday,1/30/2020,4486,3499,3031,468
Friday,1/31/2020,3527,2704,2304,400
Saturday,2/1/2020,2514,1995,1728,267
Sunday,2/2/2020,2993,2409,2106,303
Monday,2/3/2020,4728,3694,3174,520
Tuesday,2/4/2020,4883,3982,3472,510
Wednesday,2/5/2020,5071,4061,3528,533
Thursday,2/6/2020,4638,3715,3217,498
Friday,2/7/2020,3757,2942,2512,430
Saturday,2/8/2020,2761,2193,1890,303
Sunday,2/9/2020,3423,2849,2498,351
Monday,2/10/2020,5066,4016,3464,552
Tuesday,2/11/2020,4928,4045,3499,546
Wednesday,2/12/2020,4996,4019,3497,522
Thursday,2/13/2020,5004,3823,3188,635
Friday,2/14/2020,3675,2949,2529,420
Saturday,2/15/2020,2556,2024,1757,267
Sunday,2/16/2020,3732,2808,2361,447
Monday,2/17/2020,4958,3951,3382,569
Tuesday,2/18/2020,4869,3806,3273,533
Wednesday,2/19/2020,5224,4042,3495,547
Thursday,2/20/2020,4890,3748,3212,536
Friday,2/21/2020,3678,2914,2528,386
Saturday,2/22/2020,2456,2025,1759,266
Sunday,2/23/2020,3444,2708,2387,321
Monday,2/24/2020,5000,3974,3390,584
Tuesday,2/25/2020,5496,4210,3601,609
Wednesday,2/26/2020,5059,4014,3468,546
Thursday,2/27/2020,4813,3759,3247,512
Friday,2/28/2020,3810,3052,2569,483
Saturday,2/29/2020,2682,2169,1858,311
Sunday,3/1/2020,3332,2754,2379,375
Monday,3/2/2020,4872,3801,3264,537
Tuesday,3/3/2020,5097,3956,3452,504
Wednesday,3/4/2020,4714,3591,3118,473
Thursday,3/5/2020,5048,3994,3428,566
Friday,3/6/2020,3698,2843,2386,457
Saturday,3/7/2020,2670,2095,1798,297
Sunday,3/8/2020,3416,2743,2362,381
Monday,3/9/2020,4731,3830,3269,561
Tuesday,3/10/2020,4820,3718,3169,549
Wednesday,3/11/2020,4813,3711,3182,529
Thursday,3/12/2020,4393,3508,2952,556
Friday,3/13/2020,3316,2613,2172,441
Saturday,3/14/2020,2416,1888,1569,319
Sunday,3/15/2020,2934,2251,1937,314
Monday,3/16/2020,2732,2157,1809,348
Tuesday,3/17/2020,3805,3007,2525,482
Wednesday,3/18/2020,3748,2976,2508,468
Thursday,3/19/2020,3678,2883,2471,412
Friday,3/20/2020,3322,2647,2239,408
Saturday,3/21/2020,2701,2049,1749,300
Sunday,3/22/2020,3263,2469,2120,349
Monday,3/23/2020,4105,3166,2690,476
Tuesday,3/24/2020,4156,3247,2766,481
Wednesday,3/25/2020,4153,3367,2878,489
Thursday,3/26/2020,4256,3394,2944,450
Friday,3/27/2020,3818,3002,2588,414
Saturday,3/28/2020,3045,2438,2103,335
Sunday,3/29/2020,4079,3047,2603,444
Monday,3/30/2020,4899,3852,3280,572
Tuesday,3/31/2020,4943,3822,3310,512
Wednesday,4/1/2020,4907,3799,3317,482
Thursday,4/2/2020,4933,3838,3305,533
Friday,4/3/2020,4665,3498,2975,523
Saturday,4/4/2020,3366,2536,2175,361
Sunday,4/5/2020,3976,3045,2644,401
Monday,4/6/2020,4981,3921,3351,570
Tuesday,4/7/2020,5331,4144,3552,592
Wednesday,4/8/2020,5331,4203,3656,547
Thursday,4/9/2020,5063,3982,3426,556
Friday,4/10/2020,4252,3354,2869,485
Saturday,4/11/2020,3656,2712,2279,433
Sunday,4/12/2020,4152,3125,2666,459
Monday,4/13/2020,5089,3922,3379,543
Tuesday,4/14/2020,5491,4314,3721,593
Wednesday,4/15/2020,5665,4424,3754,670
Thursday,4/16/2020,5423,4203,3592,611
Friday,4/17/2020,4688,3682,3146,536
Saturday,4/18/2020,4055,3007,2521,486
Sunday,4/19/2020,4830,3671,3057,614
Monday,4/20/2020,5908,4517,3869,648
Tuesday,4/21/2020,5633,4377,3722,655
Wednesday,4/22/2020,5786,4520,3856,664
Thursday,4/23/2020,5967,4758,4074,684
Friday,4/24/2020,4937,3879,3319,560
Saturday,4/25/2020,4327,3284,2814,470
Sunday,4/26/2020,5086,3964,3393,571
Monday,4/27/2020,6038,4771,4054,717
Tuesday,4/28/2020,6324,4920,4210,710
Wednesday,4/29/2020,6062,4735,4006,729
Thursday,4/30/2020,5520,4375,3776,599
Friday,5/1/2020,4670,3621,3068,553
Saturday,5/2/2020,4171,3145,2683,462
Sunday,5/3/2020,4716,3648,3067,581
Monday,5/4/2020,5939,4567,3882,685
Tuesday,5/5/2020,6361,4900,4169,731
Wednesday,5/6/2020,6659,5322,4580,742
Thursday,5/7/2020,6264,4857,4067,790
Friday,5/8/2020,5359,4202,3592,610
Saturday,5/9/2020,4593,3452,2932,520
Sunday,5/10/2020,5092,3917,3338,579
Monday,5/11/2020,6563,5112,4278,834
Tuesday,5/12/2020,6124,4775,4028,747
Wednesday,5/13/2020,5817,4596,3886,710
Thursday,5/14/2020,6057,4583,3937,646
Friday,5/15/2020,4958,3829,3183,646
Saturday,5/16/2020,3651,2827,2384,443
Sunday,5/17/2020,4248,3291,2737,554
Monday,5/18/2020,5624,4231,3588,643
Tuesday,5/19/2020,5595,4300,3666,634
Wednesday,5/20/2020,5213,4106,3466,640
Thursday,5/21/2020,5156,3990,3372,618
Friday,5/22/2020,4350,3343,2816,527
Saturday,5/23/2020,3446,2696,2291,405
Sunday,5/24/2020,3945,2969,2479,490
Monday,5/25/2020,4639,3610,3054,556
Tuesday,5/26/2020,5224,4069,3416,653
Wednesday,5/27/2020,5242,4105,3474,631
Thursday,5/28/2020,4939,3966,3371,595
Friday,5/29/2020,4387,3486,2949,537
Saturday,5/30/2020,3327,2583,2189,394
Sunday,5/31/2020,3692,2919,2482,437
Monday,6/1/2020,4734,3707,3133,574
Tuesday,6/2/2020,4727,3690,3057,633
Wednesday,6/3/2020,4994,3869,3239,630
Thursday,6/4/2020,4767,3733,3156,577
Friday,6/5/2020,4124,3247,2778,469
Saturday,6/6/2020,3230,2425,2045,380
Sunday,6/7/2020,3906,3049,2574,475
Monday,6/8/2020,4895,3787,3188,599
Tuesday,6/9/2020,4871,3644,3050,594
Wednesday,6/10/2020,4989,3857,3269,588
Thursday,6/11/2020,4633,3560,3015,545
Friday,6/12/2020,4475,3292,2757,535
Saturday,6/13/2020,2967,2304,1942,362
Sunday,6/14/2020,3507,2684,2282,402
Monday,6/15/2020,4337,3348,2794,554
Tuesday,6/16/2020,4470,3461,2964,497
Wednesday,6/17/2020,4439,3450,2898,552
Thursday,6/18/2020,4895,3677,3132,545
Friday,6/19/2020,3924,2911,2459,452
Saturday,6/20/2020,2827,2190,1851,339
Sunday,6/21/2020,3481,2668,2256,412
Monday,6/22/2020,4627,3493,2935,558
Tuesday,6/23/2020,4561,3493,2950,543
Wednesday,6/24/2020,4626,3521,2982,539
Thursday,6/25/2020,4137,3215,2668,547
Friday,6/26/2020,3555,2675,2248,427
Saturday,6/27/2020,2671,1999,1680,319
Sunday,6/28/2020,3486,2635,2233,402
Monday,6/29/2020,4000,3119,2616,503
Tuesday,6/30/2020,3828,3013,2553,460
Wednesday,7/1/2020,3935,3049,2599,450
Thursday,7/2/2020,3633,2881,2397,484
Friday,7/3/2020,2997,2286,1932,354
Saturday,7/4/2020,2194,1704,1420,284
Sunday,7/5/2020,2948,2198,1836,362
Monday,7/6/2020,4049,3215,2724,491
Tuesday,7/7/2020,3792,2998,2485,513
Wednesday,7/8/2020,4029,3096,2613,483
Thursday,7/9/2020,3945,3039,2587,452
Friday,7/10/2020,3523,2620,2173,447
Saturday,7/11/2020,2646,1981,1665,316
Sunday,7/12/2020,3454,2611,2213,398
Monday,7/13/2020,3703,2916,2459,457
Tuesday,7/14/2020,3680,2853,2397,456
Wednesday,7/15/2020,3479,2627,2196,431
Thursday,7/16/2020,3756,2916,2463,453
Friday,7/17/2020,3289,2557,2122,435
Saturday,7/18/2020,2416,1892,1606,286
Sunday,7/19/2020,2793,2197,1892,305
Monday,7/20/2020,3749,2881,2428,453
Tuesday,7/21/2020,3786,2889,2450,439
Wednesday,7/22/2020,4002,3039,2566,473
Thursday,7/23/2020,3823,3033,2525,508
Friday,7/24/2020,3430,2623,2262,361
Saturday,7/25/2020,2400,1767,1487,280
Sunday,7/26/2020,2835,2207,1869,338
Monday,7/27/2020,4001,3031,2523,508
Tuesday,7/28/2020,3795,2969,2525,444
Wednesday,7/29/2020,3903,3010,2591,419
Thursday,7/30/2020,3397,2687,2265,422
Friday,7/31/2020,3005,2317,1887,430
Saturday,8/1/2020,2305,1750,1479,271
Sunday,8/2/2020,2696,1993,1701,292
Monday,8/3/2020,3866,2814,2368,446
Tuesday,8/4/2020,3826,2845,2400,445
Wednesday,8/5/2020,3673,2774,2334,440
Thursday,8/6/2020,3660,2625,2189,436
Friday,8/7/2020,3136,2364,1941,423
Saturday,8/8/2020,2223,1628,1354,274
Sunday,8/9/2020,2623,1941,1644,297
Monday,8/10/2020,3638,2745,2325,420
Tuesday,8/11/2020,3740,2742,2258,484
Wednesday,8/12/2020,3767,2904,2477,427
Thursday,8/13/2020,3621,2780,2322,458
Friday,8/14/2020,2971,2308,1922,386
Saturday,8/15/2020,2221,1696,1373,323
Sunday,8/16/2020,2724,2037,1686,351
Monday,8/17/2020,3456,2638,2181,457
Tuesday,8/18/2020,3581,2683,2184,499
Wednesday,8/19/2020,2064,1564,1297,267
